aadu => ado
aaliyah => aleaseya, alea, aliya, aliyah, allyiah, alia, aleeya, aleah
aaron => arron, aron, ahron
aarti => arti
aayesha => ayesha, ayasha, ayse, ayisha
aba => abod, abony, abos
abagail => abbe, abby, abbie, abilio, gail, abbey, abigale, abigail, abihail, abigayle
abba => abbot, abbott, absa, abbe
abbe => abba, abbot, abbott, absa, abbey, abby, abigail, abihail, abagail, abigayle, abilio, gail, abigale, abbie
abbey => abbe, abilio, gail, abigale, abigail, abihail, abagail, abigayle, abbie, abby
abbiah => abiam, abia, abijah
abbie => abbe, abby, abbey, abilio, gail, abigail, abigale, abihail, abagail, abigayle
abbondanzio => abundiantus, abbondio, abbondazio
abbondazio => abundiantus, abbondanzio, abbondio
abbondio => abbondazio, abundiantus, abbondanzio
abbot => abbott, absa, abba, abbe
abbott => absa, abbe, abba, abbot
abby => abbie, abbey, abbe, abilio, gail, abigail, abigale, abihail, abagail, abigayle
abdel => abdone, abdon
abdia => abdiel
abdiel => abdia
abdon => abdone, abdel
abdone => abdel, abdon
abe => avram, abramo, abra, abram, avrom, ibrahim, avraham, abie, braham, bram, abran, abraham, abramio
abel => abele, abell, able, ibila
abelard => abelardo, eberhard
abelardo => abelard, eberhard
abele => able, abell, abel, ibila
abell => abel, able, abele, ibila
abia => abijah, abbiah, abiam
abiam => abia, abijah, abbiah
abie => abramio, abe, avraham, abram, abran, abra, bram, ibrahim, braham, abraham, avram, abramo, avrom
abigail => abbie, abilio, gail, abby, abigale, abbey, abbe, abihail, abagail, abigayle
abigale => abbey, abagail, abigayle, abbe, abihail, abigail, abilio, gail, abbie, abby
abigayle => abbe, abby, abbie, abilio, gail, abbey, abigale, abigail, abihail, abagail
abihail => abby, abbie, abilio, gail, abbey, abbe, abagail, abigayle, abigale, abigail
abijah => abbiah, abiam, abia
abilio => gail, abigail, abigale, abbey, abihail, abagail, abigayle, abbe, abbie, abby
able => abell, abel, abele, ibila
abod => abos, abony, aba
abony => abod, abos, aba
abos => abod, abony, aba
abra => abe, braham, avraham, abram, abie, bram, ibrahim, abran, abraham, avram, abramo, avrom, abramio
abraham => avraham, abe, bram, avrom, braham, abran, abie, abram, avram, abramo, abra, ibrahim, abramio
abram => abe, braham, avraham, abie, abran, abra, bram, ibrahim, abraham, avram, abramo, avrom, abramio
abramio => braham, bram, abran, abraham, abie, abe, avraham, ibrahim, avrom, abram, abra, abramo, avram
abramo => abe, braham, avraham, bram, avrom, ibrahim, abran, abraham, avram, abram, abie, abra, abramio
abran => avraham, abe, abram, abie, bram, avrom, braham, abraham, avram, abramo, abra, ibrahim, abramio
absa => abbott, abbot, abba, abbe
abundiantus => abbondio, abbondazio, abbondanzio
acacia => acatia, acazia
acacio => achazio
acario => acharius
acatia => acacia, acazia
acazia => acacia, acatia
accorso => accursio, accursius
accursio => accursius, accorso
accursius => accorso, accursio
acharius => acario
achazio => acacio
achill => aquila, achilles, achilla, achille, akilleys, achilleo
achilla => aquila, achilles, achill, achille, akilleys, achilleo
achille => aquila, achilles, achill, achilla, akilleys, achilleo
achilleo => achilles, achill, achilla, achille, akilleys, aquila
achilles => achill, achilla, achille, akilleys, achilleo, aquila
ackerley => ackley
ackley => ackerley
ada => adah
adah => eda, ada, aline, ady, addie, della, adalee, adelaide, adara, adailia, elle, adele, ellie, adalheld, adalia, addo, adela, ado, etta, adeline, adelle
adailia => eda, ady, addie, adalheld, ellie, adah, adalia, adelle, della, adalee, adelaide, adara, elle, adele, adela, aline, adeline, etta
adair => edgar
adalardo => al adelardo
adalbert => adalbrecht, adelberto, bert, bertl, adi, adalberto, adelbert
adalberto => adi, adalbert, adelbert, bert, adelberto, bertl
adalbrecht => adalbert
adalee => eda, ady, addie, adalheld, adelaide, della, adara, ellie, adah, adalia, adelle, adailia, elle, adele, adeline, aline, etta, adela
adalfreddo => adelfried, adalfredo, adelfrid, adalfrid
adalfredo => adalfreddo, adelfried, adelfrid, adalfrid
adalfrid => adelfrid, adalfredo, adelfried, adalfreddo
adalgisa => adalgisal, adelgiese
adalgisal => adelgiese, adalgisa
adalgiso => adelchi
adalheld => eda, della, adalee, adelaide, adara, adailia, elle, adele, ellie, ady, addie, adah, adalia, adelle, adela, aline, etta, adeline
adalhelm => adelmo, adelhelm
adalia => eda, aline, della, adalee, adelaide, adara, adailia, elle, adele, ellie, ady, addie, adalheld, adah, adela, etta, adeline, adelle
adalrich => adalricus, adalrico
adalrico => adalrich, adalricus
adalricus => adalrico, adalrich
adam => adamo, adamah, adan, adie, addy, addie, adem, adams, adamson
adamah => adie, addy, addie, adams, adamson, adan, adamo, adam, adem
adamo => adan, adem, adie, addy, addie, adams, adamson, adam, adamah
adams => adie, adamo, adamah, adem, adan, addie, addy, adam, adamson
adamson => adie, adamo, adamah, adem, adan, addie, addy, adam, adams
adan => adie, addy, addie, adams, adamson, adamah, adamo, adam, adem
adara => eda, adelaide, ady, addie, adalheld, della, adalee, ellie, adah, adalia, adelle, adailia, elle, adele, adela, aline, adeline, etta
adaulfo => adolph, adolfus, adolfo, adolf, adolpho, adolphus, adolphe
addi => addy, addie, addisyn
addie => eda, adam, adamo, adamah, adem, adan, della, adalee, adelaide, adailia, adara, adele, ellie, ady, elle, adah, adie, addy, adams, adamson, adalheld, adalia, adelle, addi, addisyn, adela, aline, etta, adeline
addisen => adison, addison
addison => adison, addisen
addisyn => addi, addie, addy
addo => adah, ado
addolorata => deloris, dolores, dorrie, dora, delores
addy => addie, adams, adamson, addi, addisyn, adie, adan, adem, adamah, adamo, adam
adela => adelaide, adara, adella, dell, ady, adah, ellie, adele, elle, adailia, eda, aline, adeline, etta, adelle, adalia, adalheld, addie, adalee, della
adelaide => eda, adara, ady, addie, adalheld, adalee, della, ellie, adah, adalia, adelle, adailia, elle, adele, aline, adela, adeline, etta
adelais => adelasia
adelardo => al adalardo
adelasia => adelais
adelbert => adi, adalbert, adalberto, albert, albie, albertus, alberto, bertel, berty, bertie, alby, al, aubert, elbert, albrecht, bert, adelberto, bertl
adelberto => bert, bertl, adelbert, adalberto, adalbert, adi
adelchi => adalgiso
adele => eda, ady, addie, adalheld, ellie, adah, adalia, adelle, della, adalee, adelaide, adara, adailia, elle, adela, aline, adeline, etta, ethelbert, ethel, ethelred
adelfio => aldelfo, adelphos
adelfrid => adalfrid, adalfreddo, adalfredo, adelfried
adelfried => adalfredo, adalfrid, adalfreddo, adelfrid
adelgiese => adalgisa, adalgisal
adelhelm => adalhelm, adelmo
adeline => eda, aline, adela, della, adalee, adelaide, adara, adailia, elle, adele, ellie, ady, addie, adalheld, adalia, adelle, etta, adah
adella => adela, dell, della
adelle => eda, aline, della, adalee, adelaide, adara, adailia, elle, adele, ellie, ady, addie, adalheld, adalia, adela, etta, adeline, adah
adelmo => adelhelm, adalhelm
adelphos => aldelfo, adelfio
adem => adamah, adan, adie, addy, addie, adam, adams, adamson, adamo
ademaro => hadumar, adimaro
adena => adenna, adina, adinna
adenna => adina, adinna, adena
adeodato => adeodatus, adiodato
adeodatus => adeodato, adiodato
adi => bertl, adalbert, adalberto, adelbert, bert, adelberto
adie => addy, addie, adams, adamson, adan, adem, adamah, adamo, adam
adimaro => ademaro, hadumar
adina => adenna, adinna, adena
adinna => adina, adena, adenna
adiodato => adeodatus, adeodato
adishree => adisree
adison => addison, addisen
adisree => adishree
ado => adah, addo, aadu
adolf => adolfo, adolphe, adolphus, adolpho, adolph, adolfus, adaulfo
adolfa => adolfina, adolpha
adolfina => adolpha, adolfa
adolfo => adolf, adolphus, adolpho, adolph, adolfus, adolphe, adaulfo
adolfus => adolfo, adolf, adolphe, adolphus, adolpho, adolph, adaulfo
adolph => adolfo, adolf, adolphe, adolphus, adolpho, adolfus, adaulfo
adolpha => adolfina, adolfa
adolphe => adolfo, adolf, adolph, adolfus, adolpho, adolphus, adaulfo
adolpho => adolfo, adolf, adolph, adolfus, adolphus, adolphe, adaulfo
adolphus => adolfo, adolf, adolph, adolfus, adolphe, adolpho, adaulfo
adon => adone
adona => ady, adonna, adonne
adone => adonis, adon
adonis => adone
adonna => ady, adona, adonne
adonne => ady, adona, adonna
adrasto => adrastos
adrastos => adrasto
adrea => adrienne, adreena, adrianna, adrianne, adri, adriana, adria, hatria, age
adreena => adrienne, adriana, adrea, adria, hatria, age, adrianna, adrianne, adri
adri => adrienne, adriana, adrea, adria, hatria, age, adreena, adrianna, adrianne
adria => adreena, adrianna, adrianne, adri, adriana, adrea, hatria, age, adrienne
adrian => adrie, hadrianus, adrianus, adrien, adriano, hadrian
adriana => adrienne, adrianne, adri, adreena, adrea, adria, hatria, age, adrianna
adrianna => adrienne, adriana, adrea, adria, hatria, age, adreena, adrianne, adri
adrianne => adrienne, adriana, adrea, adria, hatria, age, adreena, adrianna, adri
adriano => adrian, adrie, hadrianus, hadrian, adrianus, adrien
adrianus => hadrian, adriano, adrian, adrie, adrien, hadrianus
adrie => hadrianus, adrianus, adrien, adrian, adriano, hadrian
adrien => hadrian, adriano, adrian, adrie, adrianus, hadrianus
adrienne => adreena, adrianna, adrianne, adri, adriana, adrea, hatria, age, adria
ady => eda, adalee, adelaide, adara, adailia, elle, adele, ellie, adah, addie, della, adalheld, adalia, adelle, adela, aline, adeline, etta, adonna, adona, adonne
affrica => africa
afra => africana, afraate
afraate => afra, africana
africa => affrica
africana => afra, afraate
africano => afro
afro => africano
afrodite => aphrodite, aphrodesia
afton => aftonio
aftonio => afton
agace => aggy, agata, agatha, agathe, aggie
agape => agapio
agapio => agape
agata => agace, aggie, agatha, agathe, aggy
agatha => aggy, agata, aggie, agathe, agace
agathe => aggy, agata, agatha, aggie, agace
age => adrienne, adreena, adrianna, adrianne, adri, adriana, adrea, adria, hatria
agenta => nessa, agnes, ines, aggie, ynes, inez, agnese, annis, agnesa, aggy, neza, ynez, annice
aggie => agathe, agata, agatha, agenta, aggy, annis, agnesa, nessa, agnes, ines, ynes, inez, agnese, ynez, neza, annice, agace
aggy => agace, annice, agatha, agathe, agenta, agnesa, agata, aggie, agnese, annis, neza, agnes, nessa, ines, ynes, inez, ynez
aglai => aglaian, aglaia
aglaia => aglaian, aglai
aglaian => aglaia, aglai
agnes => annice, agenta, annis, agnesa, aggy, nessa, ines, aggie, ynes, inez, agnese, neza, ynez
agnesa => agenta, nessa, agnes, ines, aggie, inez, agnese, annis, ynes, aggy, neza, ynez, annice
agnese => agenta, aggy, annis, agnesa, neza, nessa, agnes, ines, aggie, ynes, inez, ynez, annice
agostino => augustina, augusto, augie, gus, augustin, gussy, agustin, austin, augusta, augustus, gussie, augustine, august, gusta
agustin => gusta, augustina, august, augusto, augie, gus, augustin, gussy, austin, augustus, augusta, agostino, gussie, augustine, agustín
agustín => agustin
ahmad => hammed, muhammed, mohammed, mohammad, mehmet, amad, mohamad, mohamet, muhammad, hamid, amed, mohamed, ahmet, hamad, mahmoud, mehemet
ahmet => mohammad, mohammed, mohamad, amad, hamid, amed, mohamet, mohamed, mehemet, hamad, mahmoud, ahmad, muhammad, hammed, muhammed, mehmet
ahron => aaron, aron, arron
aileen => leener, leen
aimee => aims, aimelin, aimelyn, amie, amity, amalia, amia, ameilie, amelia, emelia, emele, amela, amala
aimelin => aimee, aimelyn, amie, aims
aimelyn => amie, aimelin, aimee, aims
aimery => aimory
aimory => aimery
aims => aimelin, aimee, aimelyn, amie
aineislis => stanislau, stanislaw, stanislav, stanislaus, stanislas, stan, stasio, stanislavsky, sztaniszláv, stanislao
ainslee => ainsworth, ainsly, ainsley, aynsley
ainsley => aynsley, ainsly, ainslee, ainsworth
ainsly => ainsworth, ainslee, ainsley, aynsley
ainsworth => ainsly, ainslee, aynsley, ainsley
aisling => aislinn
aislinn => aisling
aissa => izza, asa, issa, isa
aiyana => ajana
ajana => aiyana
akaisha => kasey, casey
akilleys => achilles, achill, achilla, achille, achilleo, aquila
aksana => axana
al => albert, adelbert, alby, elbert, albrecht, aubert, albie, albertus, alberto, bertel, berty, bertie, alyse, alicia, ally, alyce, alessa, alyson, alexis, alice, alysha, alise, alseia, lyssa, alisha, alyshia, alishea, alison, aliki, allie, alika, alissa, allyssa, ali, alyssa, alisa, allison, alix
alain => alan, allan, alano, allen
alaina => alun, alli, lani, lane, alona, ally, elaine, allie, lanny, alana, alanna, alyn, allyn, laney, laina
alaine => elaine, elaina, laney, elana, elayne, laine, alana
alan => allan, alain, alano, allen
alana => allyn, lane, alona, alli, ally, elaine, laney, lanny, allie, alaina, alanna, alyn, alun, laina, lani, alaine, elaina, elana, elayne, laine
alanna => alli, allyn, lane, alona, ally, elaine, lanny, alana, allie, alaina, alyn, alun, laina, lani, laney
alano => allen, alain, allan, alan
alard => allard
alart => adalardo, adelardo
alasdair => alastaire, alister, alistaire, alaster, alistair, alastair
alastair => alastaire, alister, alistaire, alaster, alistair, alasdair, aleksy, sander, sasha, aleksander, xander, sacha, alejo, alexei, alexander, ixsander, sandro, iksander, sandor, alessandro, alejandro, aleksandr, sandie, alec, alexandre, alecks, alek, aleks, alesandro, sanders, alex, sandy, alysander
alastaire => alistair, alasdair, alastair, alaster, alister, alistaire
alaster => alister, alistaire, alistair, alasdair, alastair, alastaire
alban => albin, alben, albion, albano, auburn, aubin
albano => albin, alban, alben, albion
alben => albion, albano, albin, alban
albert => adelbert, al, albie, albertus, alberto, bertel, berty, bertie, alby, aubert, elbert, albrecht
alberta => albertina, albertine
albertina => alberta, albertine
albertine => albertina, alberta
alberto => adelbert, albert, albrecht, aubert, al, elbert, albie, albertus, bertel, alby, berty, bertie
albertus => adelbert, albert, albrecht, aubert, al, elbert, albie, alberto, bertel, alby, berty, bertie
albie => adelbert, albert, albrecht, aubert, al, elbert, albertus, alberto, bertel, berty, bertie, alby
albin => alban, alben, albion, albano
albion => albin, alban, albione, alben, albano
albione => albion
albrecht => aubert, albie, albertus, alberto, bertel, berty, bertie, alby, al, albert, adelbert, elbert
alby => adelbert, al, elbert, albrecht, aubert, berty, bertie, albertus, alberto, bertel, albie, albert
alcander => alcandor, alcindor
alcandor => alcander, alcindor
alcindor => alcandor, alcander
alcot => alcott, walcott, walcot
alcott => walcott, walcot, alcot
aldan => aldon, alden, aldwin
aldelfo => adelphos, adelfio
alden => aldon, aldan, aldwin
alder => aldus, elden, eldred, elder
aldo => aldus, aldous
aldon => alden, aldan, aldwin
aldous => aldus, aldo
aldred => aldridge, aldren, aldrych, aldrich
aldren => aldrich, aldridge, aldred, aldrych
aldrich => aldridge, aldren, aldrych, aldred
aldridge => aldred, aldren, aldrych, aldrich
aldrych => aldridge, aldren, aldred, aldrich
aldus => aldous, aldo, alder, elder
aldwin => alden, aldan, aldon
alea => aaliyah, allyiah, aleeya, aliya, aliyah, aleaseya, aleah, alia
aleah => aliyah, aliya, alea, aleaseya, alia, aleeya, aaliyah, allyiah
aleaseya => aaliyah, allyiah, aleeya, alea, aliya, aliyah, aleah, alia
alec => alexander, aleksy, sandro, sasha, sacha, alejo, ixsander, iksander, alastair, sander, aleksander, alexei, alex, sanders, alek, xander, sandy, alysander, sandor, alessandro, alejandro, aleksandr, sandie, alexandre, alecks, aleks, alesandro
alecks => alexander, aleksy, sasha, sandro, sacha, alejo, ixsander, iksander, aleksander, alastair, alexei, alex, sanders, alek, alesandro, xander, sandy, alysander, sandor, alessandro, alejandro, aleksandr, sandie, alec, alexandre, aleks, sander
aleda => alida, aletta, alidia, allidia, alette, allida, lida
aleeya => alia, aleah, aleaseya, alea, aliya, aliyah, allyiah, aaliyah
alejanda => aliki, alley, elke, alexandria, alexine, alexina, allesandra, alexandrina, alexis, alesandra, alya, sandra, sanie, aleka, axelia, lexie, alexa, ally, zandra, aleksey, lexy, alexandra, alessandra, sandy
alejandro => alexander, sander, sandro, sasha, aleksy, sacha, alejo, ixsander, iksander, alastair, alex, aleksander, alexei, sanders, xander, alec, alexandre, alecks, alek, sandy, alysander, sandor, alessandro, alesandro, aleks, aleksandr, sandie
alejo => sandor, alessandro, alejandro, aleksandr, sandie, alec, alexandre, alecks, alek, aleks, alesandro, aleksy, alex, alexei, alexander, ixsander, iksander, sandro, sasha, aleksander, xander, alastair, sandy, alysander, sanders, sacha, sander
alek => sander, alexander, aleksy, sasha, sandro, sacha, alejo, ixsander, iksander, aleksander, alastair, alexei, alex, sanders, alec, alexandre, alecks, alesandro, xander, sandy, alysander, sandor, alessandro, alejandro, aleksandr, sandie, aleks
aleka => ally, alejanda, alexandra, aleksey, axelia, lexie, sandy, alessandra, aliki, alley, elke, alexandria, alexine, alexina, allesandra, alexandrina, alexis, alesandra, alya, sandra, sanie, alexa, zandra, lexy
aleks => aleksy, alexander, sasha, sandro, sacha, alejo, ixsander, iksander, aleksander, sander, alastair, alexei, alex, sanders, sandy, alysander, alesandro, xander, aleksandr, sandie, alec, alexandre, alecks, alek, sandor, alessandro, alejandro
aleksander => aleksy, sander, alastair, alejo, iksander, alek, aleks, alesandro, sanders, alex, alexei, alexander, ixsander, sandro, sasha, sacha, sandy, alysander, sandor, alessandro, alejandro, aleksandr, sandie, alec, alexandre, alecks, xander
aleksandr => alexander, sander, sandro, sasha, aleksy, sacha, alejo, ixsander, iksander, alastair, alex, aleksander, alexei, sanders, xander, sandie, alec, alexandre, alecks, alek, aleks, alesandro, sandy, alysander, sandor, alessandro, alejandro
aleksey => alejanda, sandy, alessandra, aliki, alley, elke, alexandria, alexine, alexina, allesandra, alexandrina, alexis, alesandra, alya, sandra, sanie, aleka, axelia, lexie, alexa, ally, zandra, alexandra, lexy
aleksy => aleks, alesandro, alex, alexei, alexander, ixsander, sandro, sasha, aleksander, xander, alastair, sanders, alec, alexandre, alecks, alek, sander, sandy, alysander, sandor, alessandro, alejandro, aleksandr, sandie, alejo, sacha, iksander
alena => olena
alene => evel, eveline, ilene, evelyn, evalyn, aveline, evalina, avelina, evelina, evette, eilen, avaline, evilio, avalina, eileen
alesandra => ally, alejanda, lexy, aleksey, alexandra, axelia, lexie, sanie, aleka, alexine, alexina, allesandra, alexandrina, alexis, alya, sandra, sandy, alessandra, aliki, alley, elke, alexandria, alexa, zandra
alesandro => aleksy, alexander, sandro, ixsander, sacha, alejo, iksander, aleksander, sander, alastair, sanders, sasha, alexei, alex, alecks, alek, aleks, xander, sandy, alysander, sandor, alessandro, alejandro, aleksandr, sandie, alec, alexandre
alessa => alyson, al, alishea, alise, alseia, lyssa, alisha, alyshia, alysha, alyse, alicia, ally, alyce, alissa, alison, aliki, allie, alika, allyssa, ali, alyssa, alisa, allison, alix, alexis, alice
alessandra => ally, zandra, aleksey, lexy, alexandra, lexie, alexa, aleka, axelia, alya, sandra, sanie, allesandra, alexandrina, alexis, alesandra, alexina, sandy, aliki, alley, elke, alexandria, alexine, alejanda
alessandro => alexander, sandro, sasha, ixsander, aleksy, sacha, alejo, iksander, alastair, alex, aleksander, alexei, sander, sanders, xander, alec, alexandre, alecks, alek, sandy, alysander, sandor, alesandro, aleks, alejandro, aleksandr, sandie
alesti => les
alethea => allie, thea, althea, alithea
aletta => alidia, alette, aleda, lida, allida, allidia, alida
alette => aleda, lida, allida, allidia, alidia, aletta, alida
alex => aleksy, alexander, sander, sacha, sandro, ixsander, alejo, iksander, aleksander, alastair, sandy, alysander, sandor, alessandro, alejandro, aleksandr, sandie, sasha, alexei, alec, alexandre, alecks, alek, aleks, alesandro, sanders, xander
alex => alexavia, lexa, xavia
alexa => ally, alejanda, alexandra, aleksey, alexine, alexina, sandy, alessandra, aliki, alley, elke, alexandria, allesandra, alexandrina, alexis, alesandra, alya, sandra, sanie, aleka, axelia, zandra, lexie, lexy
alexander => aleksy, alessandro, alejandro, aleksandr, sandie, alec, alexandre, alecks, alek, aleks, alesandro, sanders, alex, alexei, sander, sacha, sandro, ixsander, alejo, sandor, alastair, iksander, aleksander, sasha, sandy, alysander, xander
alexandra => sanie, aleka, axelia, lexie, alexa, ally, zandra, alexina, aleksey, sandy, alessandra, aliki, alley, elke, alexandria, alexine, allesandra, alexandrina, alexis, alesandra, alya, sandra, alejanda, lexy
alexandre => alexander, aleksy, sandro, sasha, sacha, alejo, ixsander, iksander, alastair, sandy, alysander, aleksander, alexei, alex, sanders, alek, xander, sandor, alessandro, alejandro, aleksandr, sandie, alec, alecks, aleks, alesandro, sander
alexandria => ally, alejanda, sanie, lexy, aleksey, alexandra, lexie, alexa, aleka, axelia, alya, sandra, allesandra, alexandrina, alexis, alesandra, alexine, alexina, zandra, sandy, alessandra, aliki, alley, elke
alexandrina => ally, alejanda, lexy, aleksey, alexandra, axelia, lexie, sanie, aleka, alesandra, alya, sandra, sandy, alessandra, aliki, alley, elke, alexandria, alexine, alexina, allesandra, alexis, alexa, zandra
alexavia => lexa, alex, xavia
alexei => aleksy, alexander, sander, sacha, sandro, ixsander, alejo, alastair, iksander, aleksander, sasha, alessandro, alejandro, aleksandr, sandie, alec, alexandre, alecks, alek, aleks, alesandro, sanders, alex, sandy, alysander, sandor, xander
alexina => ally, alejanda, sanie, lexy, alexandra, aleksey, alexa, axelia, lexie, aleka, alesandra, alya, sandra, allesandra, alexandrina, alexis, sandy, alessandra, aliki, alley, elke, alexandria, zandra, alexine
alexine => ally, alejanda, sanie, lexy, aleksey, alexa, alexandra, lexie, aleka, axelia, alesandra, alya, sandra, allesandra, alexandrina, alexis, alexandria, zandra, alexina, sandy, alessandra, aliki, alley, elke
alexis => alyson, ally, alicia, al, alyce, alessa, alisha, alyshia, alisa, alseia, alishea, alyse, alysha, alise, alison, aliki, allie, alika, allyssa, ali, alyssa, allison, alix, lyssa, alissa, alice, alejanda, lexy, aleksey, alexandra, axelia, lexie, sanie, aleka, alesandra, alya, sandy, alessandra, alley, elke, alexandria, alexine, alexina, allesandra, alexandrina, alexa, zandra, sandra
alf => elfred, fred, freddie, alfie, alfrid, alfric, alfred, alfredo, allie
alfie => alfred, alfric, allie, alf, elfred, freddie, alfredo, alfrid, fred
alfons => alfonse, alphonse, alphonso, alfonso, alonzo, alonza, alonso
alfonse => alphonse, alfons, alphonso, alfonso, alonzo, alonza, alonso
alfonso => alfonse, alphonse, alfons, alphonso, alonzo, alonza, alonso
alfred => alfredo, freddie, fred, allie, alfie, alfric, alfrid, alf, elfred, alfreð
alfredo => freddie, fred, alf, alfrid, alfric, alfred, alfie, allie, elfred
alfreð => alfred
alfric => alf, elfred, fred, alfie, alfred, allie, freddie, alfredo, alfrid
alfrid => alfredo, freddie, allie, alfred, alf, elfred, alfie, alfric, fred
alger => elgar, elger
algernon => algie
algie => algernon
ali => alyson, ally, allah, al, alisha, alyce, alessa, alicia, alseia, alyshia, alisa, alissa, alyssa, lyssa, allison, alison, aliki, allie, alika, allyssa, alishea, alyse, alysha, alise, alexis, alice, alix
alia => aleah, aleeya, aaliyah, allyiah, aliyah, aliya, alea, aleaseya
alice => alyson, ally, alicia, al, alyce, alessa, alisha, alyshia, alisa, alseia, alishea, alyse, alysha, alise, alison, aliki, allie, alika, allyssa, ali, alyssa, allison, alix, alexis, lyssa, alissa
alicia => alyson, al, lyssa, alisha, alyshia, alishea, alyse, alissa, alyssa, alisa, allison, alix, alexis, alice, alysha, alise, alseia, alessa, alyce, alison, allyssa, ali, aliki, allie, alika, ally
alida => allidia, aletta, alidia, alette, aleda, allida, lida
alidia => alette, aleda, lida, allida, aletta, allidia, alida
alika => alyson, ally, al, alisha, alyce, alessa, alicia, alseia, alyshia, allison, alisa, alyssa, lyssa, alison, aliki, allie, alissa, allyssa, ali, alishea, alyse, alise, alexis, alice, alysha, alix
aliki => alyson, ally, al, alisha, alessa, alicia, alyce, alseia, alyshia, allison, alix, alisa, alyssa, lyssa, alison, alika, alissa, allyssa, ali, alishea, alyse, allie, alise, alexis, alice, alysha, zandra, alejanda, lexy, aleksey, alley, alexandra, lexie, alexa, sanie, aleka, axelia, alya, sandra, allesandra, alexandrina, alesandra, alexina, sandy, alessandra, elke, alexandria, alexine
alimaia => allihmyir, almaye, ameerah, amira, almaia, almira
aline => eda, adalia, adelle, etta, adeline, adah, adela, adelaide, adara, adailia, elle, adele, ellie, ady, addie, adalheld, della, adalee
alisa => alyson, ally, alicia, alisha, alissa, alyce, alessa, alyshia, alexis, alice, alysha, alise, alseia, lyssa, al, alison, aliki, allie, alika, allyssa, ali, alyssa, allison, alix, alishea, alyse
alise => alyson, ally, alicia, al, alessa, alyce, alyshia, alisha, alisa, alseia, alyse, alishea, alison, aliki, allie, alika, allyssa, ali, alyssa, allison, alix, alexis, alice, alysha, lyssa, alissa
alisha => alyson, alicia, ally, alisa, allison, alix, al, alessa, alison, aliki, allie, alika, allyssa, ali, alyssa, alyce, alyse, alexis, alice, alise, alseia, lyssa, alysha, alissa, alishea, alyshia
alishea => alyson, ally, alicia, al, alessa, alyce, alyse, alison, aliki, allie, alika, allyssa, ali, alyssa, alisa, allison, alix, alexis, alice, alysha, alise, alseia, lyssa, alisha, alyshia, alissa
alison => alyson, ally, al, alisha, alessa, alix, alicia, alyce, alseia, alyshia, allison, alisa, alyssa, lyssa, allie, aliki, alika, alissa, allyssa, ali, alishea, alyse, alise, alexis, alice, alysha
alissa => alyson, alicia, alessa, al, alisa, alyce, alyse, ally, alisha, alseia, ali, alyssa, lyssa, allison, alison, aliki, allie, alika, allyssa, alyshia, alishea, alysha, alise, alix, alexis, alice
alistair => alastaire, alistaire, alister, alaster, alasdair, alastair
alistaire => alaster, alistair, alasdair, alastair, alastaire, alister
alister => alistaire, alaster, alistair, alasdair, alastair, alastaire
alithea => althea, alethea, allie, thea
alix => alyson, ally, alicia, alyce, alessa, alison, aliki, alisha, alyshia, al, alseia, alisa, alishea, alyse, alysha, alise, lyssa, alissa, alexis, alice, allie, alika, allyssa, ali, alyssa, allison
aliya => aaliyah, allyiah, aleeya, alea, aliyah, aleaseya, aleah, alia
aliyah => aaliyah, allyiah, aleeya, alea, aliya, aleaseya, alia, aleah
aliza => liz, arlise, eliza, isabella, ellie, bettie, elizabeth, arlisa, beth, betsy, elise, libby, ellyzabeth, elsa, lizzie, elyse, bess, bette, elysia, elsie, elpeth, ilse, betty, isabelle, lizzy, lisbeth, liza, isabel, elisabeth, elsbeth
allah => ali
allan => alain, alano, allen, alan
allard => alard
allayna => allie, llaynie
allegra => allston
allen => alan, allan, alano, alain
allesandra => ally, alejanda, sanie, lexy, aleksey, alexandra, axelia, lexie, aleka, alesandra, alya, sandra, sandy, alessandra, aliki, alley, elke, alexandria, alexine, alexina, alexandrina, alexis, alexa, zandra
alley => ally, alejanda, lexy, aleksey, alexandra, zandra, lexie, alexa, sanie, aleka, axelia, alya, sandra, allesandra, alexandrina, alexis, alesandra, alexina, sandy, alessandra, aliki, elke, alexandria, alexine
alli => allyn, ally, alona, lanny, alana, alun, ariela, ario, arial, ariele, ari, aryel, rel, ariel, ariella, arielle, alaina, lane, lani, laina, elaine, laney, alyn, alanna, allie
allida => alida, allidia, aletta, alidia, alette, lida, aleda
allidia => aletta, alidia, alette, aleda, allida, alida, lida
allie => allyn, lane, alona, elaine, laney, alaina, lanny, alana, alanna, alyn, ally, alun, laina, lani, elfred, alfredo, freddie, fred, alfred, alfric, alfrid, alyson, alfie, alf, al, alisha, alyce, alessa, alicia, alseia, alyshia, allison, alisa, alyssa, lyssa, alethea, althea, alithea, aliki, alison, alika, alissa, allyssa, ali, alishea, alyse, allayna, llaynie, alise, alexis, alice, alysha, alix, thea, alli
allihmyir => almira, almaia, amira, ameerah, almaye, alimaia
allison => alyson, ally, alicia, alisha, alyce, alessa, alseia, alyshia, alison, aliki, allie, alika, al, alisa, allyssa, ali, alyssa, lyssa, alissa, alishea, alyse, alysha, alise, alexis, alice, alix
allston => allegra
ally => allyn, lane, alona, alli, lanny, alana, alanna, alyn, alaina, elaine, laney, allie, alun, laina, lani, alyson, al, alishea, alyse, alison, aliki, alika, allyssa, ali, alyssa, alisa, allison, alix, alexis, alice, alysha, alise, alseia, lyssa, alisha, alyshia, alessa, alyce, alicia, alissa, lexy, sandy, alessandra, alley, elke, alexandria, alexine, alexina, allesandra, alexandrina, alesandra, alya, sandra, sanie, aleka, axelia, lexie, alexa, alejanda, alexandra, aleksey, zandra
allyiah => alea, aliya, aliyah, aleaseya, aaliyah, aleeya, alia, aleah
allyn => ally, alona, lanny, alana, allie, alanna, alyn, alli, elaine, laney, laina, lani, lane, alaina, alun
allyssa => alyson, ally, al, alisha, alyce, alessa, alicia, alseia, alyshia, alisa, alyssa, lyssa, allison, alison, aliki, allie, alika, alissa, ali, alishea, alyse, alise, alexis, alice, alysha, alix
almaia => allihmyir, almira, almaye, ameerah, amira, alimaia
almaye => alimaia, allihmyir, ameerah, amira, almaia, almira
almira => allihmyir, almaia, amira, almaye, ameerah, alimaia
alona => allyn, ally, alaina, lanny, alana, allie, alanna, alyn, elaine, laney, laina, lani, lane, alli, alun
alonso => alonza, alonzo, alfonso, alphonso, alfons, alphonse, alfonse
alonza => alonso, alonzo, alfonso, alphonso, alfons, alphonse, alfonse
alonzo => alonso, alfonse, alphonse, alfons, alphonso, alfonso, alonza
aloysia => louisa, lulu, louise, luise, lisette, lou, ouisa, luisa, eloisa, ouise, loise, lulie, louisiana, luane, lu, eloise, loyce, liusadh, luana, luwana, lois
alphonse => alfonse, alfons, alphonso, alfonso, alonzo, alonza, alonso
alphonso => alfonse, alphonse, alfons, alfonso, alonzo, alonza, alonso
alseia => alyson, alicia, ally, al, alessa, alyce, alyshia, alison, aliki, allie, alika, allyssa, ali, alyssa, allison, alix, alisha, alisa, alexis, alice, alysha, alise, lyssa, alissa, alyse, alishea
alston => alton
althea => thea, allie, alethea, alithea
alton => alston
altán => ultan
alun => elaine, laney, laina, lani, alaina, lanny, alana, allie, alanna, alyn, alli, ally, alona, lane, allyn
alvin => alwyn
alwyn => alvin
alya => lexy, ally, alejanda, aleksey, alexandra, axelia, lexie, sanie, aleka, sandy, alessandra, aliki, alley, elke, alexandria, alexine, alexina, allesandra, alexandrina, alexis, alesandra, sandra, alexa, zandra
alyce => alyson, al, alessa, alika, allyssa, ali, alyssa, alisa, allison, alix, alexis, alice, alysha, alise, alseia, lyssa, alisha, alyshia, alishea, alyse, alicia, ally, alissa, alison, aliki, allie
alyn => allyn, lane, alona, ally, elaine, lanny, alana, allie, alanna, alaina, alun, laina, lani, laney, alli
alysander => sandro, sasha, aleksy, sacha, ixsander, iksander, alejo, alastair, alexandre, alex, aleksander, alexander, sander, alexei, aleks, sanders, xander, alec, alecks, alek, sandy, sandor, alessandro, alejandro, alesandro, aleksandr, sandie
alyse => alyson, al, alicia, alessa, alyce, alisha, alyshia, alishea, alissa, ally, alysha, alise, alseia, lyssa, alison, aliki, allie, alika, allyssa, ali, alyssa, alisa, allison, alix, alexis, alice
alysha => alyson, ally, alicia, al, alessa, alyce, alyshia, alisha, alisa, alseia, alyse, alishea, ali, alyssa, allison, alix, alexis, alice, lyssa, alissa, alise, alison, aliki, allie, alika, allyssa
alyshia => alyson, alicia, ally, al, alessa, alyce, alise, alseia, alyse, alison, aliki, allie, alika, allyssa, ali, alyssa, alisa, allison, alix, alexis, alice, alysha, alishea, lyssa, alisha, alissa
alyson => alissa, allison, alix, alexis, alice, alysha, alise, alseia, lyssa, alisha, alyshia, alishea, alyse, alicia, ally, alyce, alessa, alison, aliki, allie, alika, al, allyssa, ali, alyssa, alisa
alyssa => alyson, ally, alicia, alisha, al, alyce, alessa, alseia, alyshia, alisa, alison, aliki, allie, alika, allyssa, ali, alissa, lyssa, allison, alishea, alyse, alysha, alise, alexis, alice, alix
amabel => mabel, maybelle, maibelle, maybelline, mabry, mabella
amad => hamid, mohamet, amed, mohammed, hammed, mehemet, muhammed, mehmet, mohamed, ahmet, muhammad, hamad, mahmoud, ahmad, mohamad, mohammad
amadeus => amadis, amado
amadi => birth
amadis => amado, amadeus
amado => amadeus, amadis
amala => ameilie, amelia, emelia, aimee, emele, amela, amity, amia, amalia
amalia => amia, amelia, emelia, aimee, emele, amity, amala, ameilie, amela
aman => amandeep
amanda => mandie, mandi, mandy
amandeep => aman
amara => mara, amarande
amarande => amara, mara
amber => ambria, bria, ria, ambert
amberleigh => amberley, amberlie
amberley => amberleigh, amberlie
amberlie => amberley, amberleigh
ambert => amber
ambria => amber, bria, ria
ambrose => ambrosia
ambrosia => ambrose
amed => amad, mohammad, mohamad, mehmet, mohamet, mohamed, ahmet, hamad, mahmoud, ahmad, hamid, muhammad, mehemet, hammed, muhammed, mohammed
ameer => amir
ameerah => almaye, alimaia, allihmyir, amira, almaia, almira
ameilie => amia, amela, amelia, emelia, aimee, emele, amala, amity, amalia
amela => emelia, aimee, emele, amalia, amia, amity, amala, amelia, ameilie
amelia => amity, amalia, amia, amela, ameilie, emelia, aimee, emele, amala
amena => amina
amia => ameilie, amelia, emelia, aimee, amity, amala, amela, amalia, emele
amie => aims, aimelin, aimee, aimelyn
amina => amena
amir => ameer
amira => ameerah, almaye, alimaia, allihmyir, almira, almaia
amity => amala, amela, emele, aimee, emelia, amelia, ameilie, amia, amalia
ammon => edmund, amon, eamon, eammon
amon => edmund, eammon, ammon, eamon
amory => emery, emory
amreeta => amrita
amrita => amreeta
ana => anitia, anna, annette, annie, anita, anneka, nanette, ann, anca, anika, annice, anuschka, annys, anja, anya, anushka, anne, annika, annis, lana, iyana, ilani, ilana
anaar => anar
anabel => anna, anabelle, annabelle, bella, annabella, ann, belle, annabel
anabelle => annabelle, bella, annabella, ann, belle, annabel, anabel, anna
anaia => anaya
analyn => annalynne, annalynn, analynne, annalisa
analynne => analyn, annalynn, annalisa, annalynne
anand => ananda
ananda => anand
anar => anaar
anastace => anastice, anastasio, stacey, natasha, stacia, tasia, anstasie, stasa, tasha, anastasius, stacy, anastasia
anastasia => stasa, anastasius, stacia, tasha, anstasie, tasia, anastace, anastice, stacy, natasha, stacey, anastasio
anastasio => stasa, anastasius, stacia, tasha, tasia, anastace, anastasia, natasha, stacey, stacy, anstasie, anastice
anastasius => anastace, stasa, tasha, stacia, tasia, anstasie, stacy, anastasia, anastice, anastasio, stacey, natasha
anastice => stasa, anastasius, stacia, tasha, anstasie, tasia, anastace, anastasia, natasha, stacy, stacey, anastasio
anatole => anatoly
anatoly => anatole
anaya => anaia
anca => ana, anja, anushka, annika, anya, anne, anna, annette, annie, anita, anneka, nanette, ann, annice, anuschka, annys, annis, anika, anitia
ancel => anselm, ancell, lancelot, launcelot, lance, ancelot, anselmo, ansel, anselme
ancell => anselm, ancel, ancelot, anselmo, ansel, anselme
ancelot => anselme, ansel, anselmo, anselm, ancell, ancel
anders => andrys, andré, andie, andy, anderson, andrew, andres, andreas, drew, andrei, andros, andrey, andrea, andrews, andries
anderson => andy, anders
andie => andrey, anders, andrews, andries, andrei, drew, andrew, andres, andrys, andré, andros, andreas, andrea, andy, andreana
andra => zandria, zandra, andria
andraya => rai, raya, ray
andrea => andy, andreana, andie, andrys, andré, andros, andrew, andres, andreas, drew, andrei, andrey, anders, andrews, andries
andreana => andie, andrea, andy
andreas => andré, andros, drew, andrew, andres, andrey, andrea, andy, anders, andrews, andries, andrei, andrys, andie
andreea => andria
andrei => andie, andrew, andres, andreas, andy, andries, drew, andrey, andrea, anders, andrews, andros, andré, andrys
andres => andreas, andrey, andrea, andy, anders, andrews, andries, andrei, andrys, andré, andros, drew, andrew, andie
andrew => andreas, andrey, andrea, andy, anders, andrews, andries, andrei, andré, andros, drew, andrys, andres, andie
andrews => andie, andrew, andres, andreas, drew, andrei, andros, andrey, andrea, andy, anders, andries, andré, andrys
andrey => andreas, andie, andrew, andres, andrys, drew, andrei, andrea, andy, anders, andrews, andries, andros, andré
andria => andreea, andra, zandria, zandra
andries => andie, andrew, andres, andreas, andrei, drew, andros, andrey, andrea, anders, andrews, andy, andré, andrys
andros => andreas, drew, andrew, andres, andy, anders, andrews, andries, andrei, andré, andrys, andie, andrea, andrey
andrys => andré, andrew, andres, andreas, andrey, drew, andros, andie, andrea, andrei, andries, andrews, anders, andy
andré => andreas, andrew, andres, drew, andros, andie, andrys, andrei, andries, andrews, anders, andy, andrea, andrey
andy => andrea, andreana, andie, andrys, andré, anders, anderson, andrew, andres, andreas, andrei, drew, andros, andrey, andrews, andries
aneya => neya
ange => angelica, angela, angel, angelic, angell, angie, anjelica, angelina
angel => angelica, ange, anjelica, angelina, angela, angelic, angevin, angelus, angie, angell
angela => angelica, ange, angel, angelic, angell, angie, angelina, anjelica
angelic => angelica, ange, angie, anjelica, angelina, angela, angel, angell
angelica => angelina, angela, angel, angelic, angell, ange, angie, anjelica
angelico => angelo
angelina => angelica, angel, angelic, angie, angela, anjelica, angell, ange
angell => angelica, ange, angie, anjelica, angela, angel, angelic, angelina
angelo => angelico
angelus => angie, angel, angevin
angevin => angel, angie, angelus
angie => angelica, angelic, angell, angevin, angelus, angelina, angela, anjelica, angel, ange
ani => anita, neats, anitra
anica => anika
anika => ana, anica, anja, anushka, annika, anya, anne, anna, annis, annette, annie, anita, anneka, nanette, ann, anca, annice, anuschka, annys, anitia
anisa => anissa
anissa => anisa
anita => ana, anitia, anitra, neats, anya, anne, anna, annette, annie, annice, anuschka, anneka, annis, anja, annika, ani, annys, ann, anca, nanette, anika, anushka
anitia => ann, anja, annika, annis, nanette, anneka, annice, annie, annette, anna, anne, anushka, anita, anya, annys, anuschka, ana, anika, anca
anitra => anita, neats, ani
anja => nanette, ann, anca, anika, annice, ana, anya, anitia, anushka, anne, anna, annette, annie, anita, anneka, anuschka, annys, annika, annis
anjelica => angelica, angel, angelic, angell, angie, angelina, angela, ange
ank => anka, raida, anki, ankareeda
anka => anke, anki, ankareeda, raida, ank
ankareeda => raida, ank, anki, anka
anke => anka
anki => ankareeda, raida, ank, anka
ann => anna, anabel, anabelle, annabelle, bella, annabel, annabella, belle, ana, anitia, anja, anushka, annika, anya, anne, annette, annie, anita, anneka, nanette, annice, anuschka, annys, anca, annis, anika
anna => anabel, anabelle, annabelle, bella, annabella, ann, belle, annabel, ana, anitia, annie, anita, anneka, anne, anuschka, annette, annis, anya, annice, anja, annika, anca, anika, nanette, annys, anushka, ausiana, aussi, aussie, lani, liannaka, lan, lanna
annabel => belle, annabelle, bella, annabella, ann, anna, anabel, anabelle
annabella => annabel, ann, belle, bella, annabelle, anabelle, anabel, anna
annabelle => bella, annabella, ann, annabel, belle, anna, anabelle, anabel
annalisa => annalynne, analyn, analynne, annalynn
annalynn => analyn, analynne, annalisa, annalynne
annalynne => annalisa, annalynn, analynne, analyn
anne => annie, anita, anneka, nanette, anna, annice, anuschka, annette, annis, anya, anja, ana, annika, ann, anca, anika, annys, anushka, anitia
anneka => ana, anitia, anya, anne, anna, annette, annie, anita, annice, anuschka, annis, anja, annika, annys, ann, anca, nanette, anika, anushka
annette => ana, anitia, annie, anita, anneka, anya, anne, anna, annice, anuschka, annis, anja, annika, ann, anca, nanette, annys, anika, anushka
annice => neza, aggie, ynes, inez, agnese, annis, agnesa, agenta, ynez, ana, anitia, annie, anita, anneka, anja, anne, anuschka, annette, anya, anna, annika, annys, ann, anca, nanette, anika, anushka, ines, agnes, aggy, nessa
annie => ana, anitia, anya, anne, anna, annette, annice, anuschka, anita, anneka, annis, anja, annika, annys, ann, anca, nanette, anika, anushka, bethel, beth, bethanie, bethannie, bethesda, bethany, betheny
annika => annis, anja, anuschka, ana, annice, anika, anca, ann, annys, nanette, anneka, anita, annie, annette, anna, anne, anushka, anitia, anya
annis => agenta, neza, nessa, agnes, ines, aggie, ynes, inez, agnese, aggy, agnesa, ynez, annice, anushka, anne, anna, annette, annie, anita, anneka, nanette, anya, anitia, annika, ann, anca, anika, ana, anuschka, anja, annys
annys => ana, anushka, anja, annika, anita, anneka, nanette, annice, anuschka, ann, anca, anya, anne, anna, annette, annie, annis, anika, anitia
anschel => ashe, asher, ashbel, asser
ansel => anselmo, anselme, ancelot, ancell, ancel, anselm
anselm => ancel, ancell, ancelot, anselme, anselmo, ansel
anselme => ansel, anselmo, ancel, anselm, ancelot, ancell
anselmo => ansel, anselme, ancelot, ancell, ancel, anselm
ansen => ansonia, hanson, anson, hansen
anson => hansen, ansonia, hanson, ansen
ansonia => hansen, anson, hanson, ansen
anstasie => stasa, anastasius, tasia, stacia, tasha, anastice, anastasia, stacy, natasha, stacey, anastasio, anastace
anth => anton, anthoney, nee, antonius, antone, tee, antoine, anthony, antonio, tonio, tony, tonie, toney, antony, tone, toni
anthoney => toney, antoine, antonio, tone, tony, anth, anthony, antonius, tonio, tee, nee, anton, antony, tonie, antone, toni
anthony => anton, toni, nee, anthoney, antonius, antone, antoine, tone, tony, anth, antony, toney, antonio, tonio, tee, tonie
antoine => antonella, antonia, anthoney, antonius, antone, anton, tony, anth, antony, anthony, antonio, tonio, toney, tone, tonie, nee, toni, tonya, toinette, antonellina, antoinetta, antoinette, tonia, tee
antoinetta => tonia, tonya, antoine, antonella, toni, antonia, tony, toinette, antoinette, antonellina
antoinette => tonya, antoine, antonella, toni, antonia, tony, toinette, antoinetta, antonellina, tonia
anton => toni, anth, anthoney, tee, nee, antoine, antonio, tone, tony, tonie, anthony, antony, antone, toney, tonio, antonius
antone => nee, antoine, antonio, tone, tony, anth, antonius, tonio, antony, anthony, toney, tee, tonie, anton, anthoney, toni
antonella => tonia, antoinette, antoinetta, antonellina, tony, toinette, tonya, antoine, toni, antonia
antonellina => tonia, tonya, antoine, antonella, toni, antonia, tony, toinette, antoinette, antoinetta
antonia => antoinette, antoinetta, antonellina, tony, tonya, antoine, antonella, toni, toinette, tonia
antonio => anthoney, antonius, antone, anton, tee, toney, antoine, tone, tony, anth, antony, anthony, tonio, tonie, nee, toni
antonius => anton, toni, anthoney, nee, antoine, tone, tony, anth, antonio, tonio, antony, anthony, antone, tee, toney, tonie
antony => anton, toni, anthoney, nee, antonius, antone, antoine, anthony, antonio, tonio, tony, tee, tonie, anth, toney, tone
anuschka => ana, annette, annie, anita, anneka, anya, anne, anna, annice, anushka, anja, annika, annys, ann, anca, nanette, annis, anika, anitia
anushka => annis, anja, ann, anca, anika, anuschka, annys, ana, annika, anya, annice, anne, anna, annette, annie, anita, anneka, nanette, anitia
anya => annie, anita, anneka, nanette, anne, anuschka, annette, anna, annice, anja, ana, annika, annis, ann, anca, anika, annys, anushka, anitia
aphrodesia => afrodite, aphrodite
aphrodite => aphrodesia, afrodite
april => apryl, aprille, avril, ava
aprille => april, avril, ava, apryl
apryl => ava, avril, aprille, april
aquila => achill, achilla, achille, akilleys, achilles, achilleo
arabel => arabelle, arabella
arabella => arabel, arabelle
arabelle => arabel, arabella
araminta => mintha, minta, mint
arch => arky, archy, archibald, arkady, archie
archibald => arkady, archie, arch, archy, arky
archie => arch, arkady, archibald, archy, arky
archy => archibald, arkady, archie, arch, arky
arden => ardis, ardon
ardis => arden, ardon
ardon => arden, ardis
aree => ari
ari => aree, arianne, arianna, ariana, ariyaunna, rianna, ariadne, arial, arielle, ariela, aryel, rel, alli, ariel, ariella, ario, aria, ariele
aria => arie, ariadne, arianna, ariah, ari, arianne, rianna, ariyaunna, ariana
ariadne => aria, arianne, arianna, ariana, ariyaunna, rianna, ari
ariah => aria, arie
arial => ariela, ari, aryel, rel, alli, ariel, ariella, arielle, ariele, ario
ariana => aria, ariadne, ari, arianne, arianna, ariyaunna, rianna
arianna => aria, ariadne, ari, arianne, ariana, ariyaunna, rianna
arianne => ariadne, ari, arianna, ariana, ariyaunna, rianna, aria
arie => aria, ariah
ariel => ario, arial, ariele, ari, aryel, rel, alli, ariella, arielle, ariela
ariela => ariele, ari, aryel, rel, arielle, arial, ario, ariella, ariel, alli
ariele => arielle, ariela, aryel, rel, alli, ariel, ariella, ario, ari, arial
ariella => ario, ariele, ari, aryel, rel, alli, ariel, arielle, ariela, arial
arielle => ariele, ari, aryel, rel, alli, ariel, ariella, ario, arial, ariela
ario => ariel, ariella, ariele, ari, aryel, rel, alli, arielle, ariela, arial
ariyaunna => ariadne, ari, arianne, arianna, ariana, rianna, aria
arkady => archie, arch, archibald, archy, arky
arky => archy, archibald, arkady, archie, arch
arland => arles, arlie, arliss, arly, arlyss, arlen, arlo, arleigh
arleen => arlyn, arleine, arlen, arlette, arlynn, arlene, arline
arleigh => arly, arlie, arles, arlen, arlyss, arland, arlo, arliss
arleine => arline, arlene, arleen, arlynn, arlyn, arlen, arlette
arlen => arlyss, arliss, arlo, arleigh, arlette, arles, arlie, arline, arlene, arleen, arlynn, arlyn, arleine, arly, arland
arlene => arlyn, arleine, arlen, arlette, arleen, arlynn, arline
arles => arlyss, arland, arly, arlie, arliss, arlo, arlen, arleigh
arlette => arline, arlene, arleen, arlynn, arlen, arleine, arlyn
arlie => arlyss, arland, arly, arles, arliss, arlo, arlen, arleigh
arline => arlene, arleen, arleine, arlen, arlette, arlynn, arlyn
arlisa => arlise, elizabeth, bettie, beth, betty, isabelle, lizzy, elise, lisbeth, liza, isabel, elisabeth, elsbeth, elyse, aliza, ilse, ellyzabeth, bess, elsie, elpeth, bette, elysia, isabella, libby, betsy, ellie, lizzie, elsa, eliza, liz
arlise => aliza, ilse, beth, ellyzabeth, bess, elsie, elpeth, bette, elysia, isabella, arlisa, libby, elsa, lizzie, elizabeth, bettie, liz, ellie, betsy, liza, isabel, elisabeth, elsbeth, elyse, lisbeth, betty, isabelle, lizzy, elise, eliza
arliss => arlyss, arlen, arly, arles, arlie, arlo, arland, arleigh
arlo => arlyss, arlen, arly, arles, arlie, arliss, arland, arleigh
arly => arland, arlyss, arleigh, arlen, arlo, arliss, arlie, arles
arlyn => arlene, arleen, arlynn, arleine, arlen, arline, arlette
arlynn => arlyn, arleine, arlen, arline, arlene, arleen, arlette
arlyss => arles, arlie, arliss, arlo, arlen, arland, arleigh, arly
arman => hermann, armando, herman, armand, armande, armond
armand => hermann, herman, armando, arman, armande, armond
armande => armando, armond, hermann, arman, herman, armand
armando => armande, armond, hermann, arman, herman, armand
armond => armande, armando, hermann, arman, herman, armand
arnald => arnaud, arnell, arnaldo, arnold, arnault, arne, arnot, arnie, arno, arness, arnel
arnaldo => arnel, arness, arno, arnie, arnot, arne, arnald, arnell, arnaud, arnault, arnold
arnaud => arness, arno, arnie, arnot, arne, arnald, arnold, arnault, arnell, arnel, arnaldo
arnault => arnaud, arnell, arnel, arness, arno, arnie, arnot, arne, arnold, arnald, arnaldo
arne => arnel, arness, arno, arnie, arnot, arnaud, arnell, arnaldo, arnold, arnault, arnald
arnel => arne, arnald, arnaud, arnell, arnaldo, arnault, arnold, arness, arno, arnie, arnot
arnell => arnel, arness, arno, arnie, arnot, arne, arnald, arnold, arnault, arnaud, arnaldo
arness => arne, arnald, arnaud, arnell, arnaldo, arnold, arnault, arnie, arnel, arno, arnot
arnie => arne, arnald, arnaud, arnell, arnaldo, arnold, arnault, arno, arness, arnel, arnot
arno => arne, arnald, arnaud, arnell, arnaldo, arnold, arnault, arnie, arnel, arness, arnot
arnold => arnaldo, arnaud, arnell, arness, arno, arnie, arnot, arne, arnald, arnault, arnel
arnot => arne, arnald, arnaud, arnell, arnaldo, arnold, arnault, arnie, arno, arness, arnel
aroa => aroha
aroha => aroa
aron => aaron, ahron, arron
arron => aron, aaron, ahron
arta => dartagnan, arthus, arte
arte => dartagnan, arthus, arta
artemis => artie, artemus
artemus => artie, artemis
arthie => arty, arthur, artu, arturo
arthur => arturo, artu, arthie, arty
arthus => dartagnan,  arte, arta
arti => aarti
artie => artemus, artemis
artu => arthur, arthie, arty, arturo
arturo => artu, arthur, arthie, arty
arty => arthie, arthur, artu, arturo
aryel => arial, arielle, ariela, ari, rel, alli, ariel, ariella, ario, ariele
asa => izza, issa, isa, aissa
ash => ashlyn, ashford, ashleigh, ashlan, ashlie, ashe, ashlin, ashi, ashli, ashby, ashley, ashling
ashamed => ashes
ashbel => ashe, anschel, asser, asher
ashby => ashlin, ashi, ashley, ashling, ash, ashlyn, ashford, ashleigh, ashlan, ashlie, ashe, ashli
ashe => anschel, asser, ashbel, ashli, ash, ashlyn, ashford, ashleigh, ashlan, ashlie, ashlin, ashi, ashby, ashley, ashling, asher
asher => anschel, asser, ashbel, ashe
ashes => ashamed
ashford => ashli, ash, ashlyn, ashleigh, ashlan, ashlie, ashe, ashlin, ashi, ashby, ashley, ashling
ashi => ashli, ash, ashlyn, ashford, ashleigh, ashlan, ashlie, ashe, ashlin, ashby, ashley, ashling
ashlan => ashli, ash, ashlyn, ashford, ashleigh, ashlie, ashe, ashlin, ashi, ashby, ashley, ashling
ashleigh => ashli, ash, ashlyn, ashford, ashlan, ashlie, ashe, ashlin, ashi, ashby, ashley, ashling
ashley => ashli, ashby, ashling, ash, ashlyn, ashford, ashleigh, ashlan, ashlie, ashe, ashlin, ashi
ashli => ashlie, ashe, ashlin, ashi, ashford, ashleigh, ashlan, ash, ashlyn, ashby, ashling, ashley
ashlie => ashli, ash, ashlyn, ashford, ashleigh, ashlan, ashe, ashlin, ashi, ashby, ashley, ashling
ashlin => ashli, ash, ashlyn, ashford, ashleigh, ashlan, ashlie, ashe, ashi, ashby, ashley, ashling
ashling => ashby, ashley, ash, ashlyn, ashford, ashleigh, ashlan, ashlie, ashe, ashlin, ashi, ashli
ashlyn => ash, ashford, ashleigh, ashlan, ashlie, ashe, ashlin, ashi, ashli, ashby, ashley, ashling
asia => fanta, fantasia
asparouh => paro, pouro
asser => ashe, asher, anschel, ashbel
asta => astred, astera, astrid, astyr
astera => astred, astrid, asta, astyr
astin => austin, austen
astred => astera, astrid, asta, astyr
astrid => astred, astera, asta, astyr
astyr => astred, astera, astrid, asta
atena => athena, athene
athena => atena, athene
athene => athena, atena
athol => avery
atrayl => tray
atrius => atrus
atrus => atrius
attis => attisian, attisa
attisa => attisian, attis
attisian => attisa, attis
aubert => albie, albertus, alberto, bertel, berty, bertie, alby, al, albrecht, elbert, adelbert, albert
aubin => auburn, alban
auburn => alban, aubin
audery => audey, audie, audrey, audra, audry
audey => audie, audrey, audra, audery, audry
audie => audry, audery, audey, audrey, audra
audlin => pale, pallid
audra => audey, audry, audery, audrey, audie
audrey => audra, audey, audry, audery, audie
audry => audery, audey, audie, audrey, audra
augie => augusto, agustin, austin, augusta, agostino, gussie, augustus, gus, augustin, gussy, augustine, augustina, august, gusta
august => gusta, agustin, austin, augusto, augustina, augustin, augustine, gussy, augusta, gus, augie, gussie, agostino, augustus
augusta => augustina, augustine, augusto, augie, gus, augustin, gussy, agustin, austin, augustus, agostino, gussie, august, gusta
augustin => augusto, augustina, agustin, austin, augustus, agostino, gussie, augie, gus, augusta, gussy, august, augustine, gusta
augustina => agustin, austin, augusta, agostino, augusto, gus, augustin, augustus, augustine, august, gusta, gussy, gussie, augie
augustine => augusto, augustina, augie, gus, agustin, austin, augustus, agostino, gussie, august, augustin, gussy, augusta, gusta
augusto => gusta, augustina, austin, augustus, augustine, agostino, gussie, augie, gus, augusta, gussy, augustin, august, agustin
augustus => augusto, augustina, gussie, augie, gus, augustin, agustin, austin, augusta, agostino, gussy, augustine, august, gusta
aurea => aurelia, aurelie, aurilia
aurelia => aurilia, aurelie, aurea
aurelie => aurea, aurilia, aurelia
aurelio => aurilio, aurelius, aurilius
aurelius => aurilio, aurilius, aurelio
aurilia => aurelie, aurelia, aurea
aurilio => aurilius, aurelio, aurelius
aurilius => aurilio, aurelius, aurelio
aurora => aurore
aurore => aurora
ausiana => anna, aussi, aussie
aussi => ausiana, anna, aussie
aussie => ausiana, anna, aussi
austen => austin, astin
austin => augustina, august, augusto, astin, austen, augie, gus, augustin, gussy, augustus, augusta, agostino, gussie, agustin, augustine, gusta
ava => apryl, avril, avaset, ev, evie, evita, evy, eve, evacsa, ewa, eva, evonne, evette, aprille, april
avalina => evel, eileen, eveline, alene, ilene, aveline, evilio, evalyn, evelyn, avaline, eilen, evette, evelina, avelina, evalina
avaline => eileen, evalyn, alene, aveline, ilene, evelyn, evalina, evelina, evette, eilen, avelina, eveline, evel, evilio, avalina
avaset => ava
ave => avery, aves, averi
avelina => eileen, eilen, evalyn, alene, ilene, evelyn, evalina, eveline, evette, evelina, avaline, evel, evilio, aveline, avalina
aveline => eileen, alene, evalina, evelina, evette, eilen, avaline, evel, evilio, eveline, ilene, evelyn, avelina, avalina, evalyn
averell => everil, haverl, averil, averill, haverhil, everill
averi => avery, aves, ave
averil => everil, haverl, averill, averell, haverhil, everill
averill => everil, haverl, averil, averell, haverhil, everill
avery => ave, aves, averi, athol
aves => averi, avery, ave
avi => avital, avivah, aviva, avia
avia => avi, avital, avivah, aviva
avital => avivah, aviva, avi, avia
aviva => avivah, avital, avi, avia
avivah => aviva, avital, avi, avia
avraham => abe, braham, bram, abran, abraham, avram, abramo, abra, abram, avrom, ibrahim, abie, abramio
avram => abe, avraham, braham, bram, avrom, abran, abraham, abram, abie, abramo, abra, ibrahim, abramio
avril => apryl, ava, april, aprille
avrom => abe, braham, avraham, bram, abran, abraham, avram, abramo, ibrahim, abra, abram, abie, abramio
axana => aksana
axel => axtel
axelia => ally, alejanda, alexandra, aleksey, alexina, allesandra, alexandrina, alexis, alesandra, alya, sandra, sanie, aleka, lexie, sandy, alessandra, aliki, alley, elke, alexandria, alexine, zandra, alexa, lexy
axtel => axel
ayasha => ayisha, ayesha, ayse, aayesha
ayelin => ayla, linn
ayesha => ayisha, ayse, aayesha, ayasha
ayisha => ayse, aayesha, ayesha, ayasha
ayla => ayelin, linn
aylen => chaylen
aylin => zayla, zaylin
aynsley => ainsley, ainsworth, ainsly, ainslee
ayse => aayesha, ayesha, ayasha, ayisha
az => azzie, oz, azadeh, azrael, ozzie
aza => azalyn, azland
azadeh => oz, ozzie, azzie, az
azalia => azaria
azalyn => azland, aza
azaria => azalia
azio => ezio
aziza => azize, azy
azize => azy, aziza
azland => azalyn, aza
azrael => az
azura => azure
azure => azura
azy => azize, aziza
azzie => az, oz, ozzie, azadeh
ba => bar, bari
babette => bärbel, bararella, barbra, barbie, barbs, babs, barbara, barby, barb, bobbie, elizabeth
babs => bärbel, barbie, bararella, barbara, babette, barby, bobbie, barbs, barb, barbra
bahar => baharak
baharak => bahar
bailee => baily, bayley, bailey, baylor
bailey => baylor, baily, bailee, bayley
baily => bayley, bailey, bailee, baylor
baird => bayless, bayard, baylor, bard
baji => jiji
baker => baxley, baxter
baldovino => balwin, baldwin, maldwyn, baldwyn
baldwin => maldwyn, baldwyn, baldovino, balwin
baldwyn => balwin, baldwin, baldovino, maldwyn
bali => balik, balin
balik => bali, balin
balin => balik, bali
balwin => baldwin, maldwyn, baldwyn, baldovino
bansari => bansuri
bansuri => bansari
bar => bari, ba
barabas => barabba
barabba => barabas
bararella => barbara, babette, barby, bärbel, bobbie, barbs, babs, barb, barbie, barbra
barb => bärbel, barbie, bararella, barbs, babs, barbara, babette, barby, bobbie, barbra
barbara => barbie, bärbel, bararella, barbra, barbs, babs, babette, barby, barb, bobbie
barber => barbour
barbie => barbs, babs, barb, bararella, babette, barby, bärbel, bobbie, barbra, barbara
barbour => barber
barbra => barbara, babette, barby, bararella, barbie, barb, babs, barbs, bobbie, bärbel
barbs => bärbel, barbie, bararella, babette, barby, bobbie, barb, babs, barbara, barbra
barby => bärbel, bararella, barbra, barbie, barbs, babs, barbara, babette, barb, bobbie
barclay => berkeley, barklay, barksdale, barkley, barks, berkley
bard => baird
bari => bar, ba
barie => barry, barris, barrymore, barrie
barklay => barksdale, barkley, barks, berkley, berkeley, barclay
barkley => barclay, berkeley, berkley, barks, barklay, barksdale
barks => barksdale, barkley, barclay, berkeley, barklay, berkley
barksdale => barclay, berkeley, barklay, berkley, barks, barkley
barn => barnaby, barnie, barnabas, barney
barnabas => barnaby, barnie, barney, barn
barnaby => barn, barnabas, barney, barnie
barnard => barney, bernie, berne, bernd, bernardo, bernhardt, barnie, bernard, bernhard, berndt, bern
barnet => barnett, barret, barr, barrett
barnett => barret, barr, barnet, barrett
barney => barnaby, barnabas, barnie, barn, bernie, berne, bernd, bern, berndt, bernhard, bernardo, bernard, bernhardt, barnard
barnie => barnaby, barnabas, barney, barn, barnard, berne, bernd, bern, berndt, bernhard, bernardo, bernard, bernhardt, bernie
baron => barron
barr => barret, barnett, barnet, barrett
barret => barr, barnett, barnet, barrett
barrett => barnet, barnett, barret, barr
barrie => barrymore, barris, barie, barry
barris => barry, barrie, barrymore, barie
barron => baron
barry => barrymore, barie, barris, barrie
barrymore => barry, barrie, barris, barie
bars => bors
bart => bat, tholy, bartolomeo, bartel, barth, parlan, bertol, barton, bartley, tolly, bartholomew, bartold, bartlett, barthol
bartel => bat, barthol, tholy,  tolly, bartholomew, bartold, bartolomeo, barth, barton, bertol, parlan, bartlett
barth => bat, barthol, tholy,  bartholomew, bartold, bartlett, bartolomeo, bartel, barton, bertol, parlan, tolly
bartholomew => barthol, tholy, tolly, bartold, bartel, bartolomeo, barth, barton, bertol, parlan, bartlett
bartlett => barthol, tholy, barth, barton, bertol, parlan, tolly, bartholomew, bartold, bartel, bartolomeo
bartley => bat, tholy,  bertol, barton, tolly, bartholomew, bartold, bartlett, bartolomeo, bartel, barth, barthol
bartold => tholy, barthol, tolly, bartholomew, bartel, bartolomeo, barth, barton, bertol, parlan, bartlett
bartolomeo => barthol, tholy, tolly, bartholomew, bartold, bartel, barth, barton, bertol, parlan, bartlett, bat
barton => bat, tholy, parlan, tolly, bartholomew, bartold, bartlett, bartolomeo, bartel, barth, bertol, barthol
basia => basya, basilia, basil, vasily, basile, vasilis, batya, bathshua, basilo, batsheva, sheba, bathsheba
basil => basia, basile, vasilis, basilo, basilia, vasily
basile => vasilis, vasily, basia, basil, basilia, basilo
basilia => basia, basile, vasilis, basilo, vasily, basil
basilo => basilia, vasily, basil, basia, vasilis, basile
bastiaan => bastian
bastian => sebestyén, bastien, sebastian, sebastien, bastiaan
bastien => sebastian, bastian, sebastien, sebestyén
basya => basia, batsheva, bathsheba, batya, sheba, bathshua
bathsheba => basya, batsheva, basia, sheba, batya, bathshua
bathshua => sheba, basya, batya, basia, batsheva, bathsheba
batsheva => basya, bathshua, basia, sheba, bathsheba, batya
batya => basya, basia, sheba, bathshua, bathsheba, batsheva
baxley => baker, baxter
baxter => baker, baxley
bayard => baird, baylor, bayless
bayless => bayard, baylor, baird
bayley => baylor, baily, bailee, bailey
baylor => bailee, baily, bayley, bailey, bayless, bayard, baird
bea => beatrice, beattie, trixy, beah, beatriz, beatrix, trixie, beatirsa
beacan => beagan
beacher => beecher
beagan => beacan
beah => beatirsa, beatrix, beatriz, trixy, beattie, beatrice, trixie, bea
beaman => beeman
beata => beate
beate => beata
beatirsa => beatrix, beatriz, beah, trixy, trixie, bea, beatrice, beattie
beatrice => trixie, beatirsa, bea, beattie, beatrix, beatriz, beah, trixy
beatrix => beatirsa, beatriz, trixy, beah, beattie, beatrice, trixie, bea
beatriz => beatirsa, beatrix, trixy, beah, beattie, beatrice, trixie, bea
beattie => beatrix, beatriz, beah, trixy, beatirsa, beatrice, bea, trixie
beau => bo, beauregard
beauregard => beau, bo
becca => lyn, beccalynn, becky, rivca, rebecca, becka, rebeque, bekki, becha, ree, rebeca, rebeka, rebekka, rebeckah, reeba, rifka, riva, rebekah, rebakah, rivka, riba, rebeccah, rivy, reba, rebequa
beccalynn => becky, lyn, becca
becha => becca, rebeka, rebeccah, rebeca, ree, reeba, rivca, rebecca, becka, rebeque, rebequa, rifka, riva, rebekah, rebakah, rivka, riba, rebekka, rebeckah, bekki, rivy, reba, becky
becka => becca, rebeka, rebeca, becky, ree, becha, bekki, rivy, rebequa, rifka, riva, rebekah, reba, rebeckah, reeba, rivca, rebecca, rebeque, rebakah, rivka, riba, rebekka, rebeccah
becky => rebeka, rebeccah, rebeca, ree, rebecca, becka, rebeque, bekki, rivy, reba, rebequa, rifka, riva, rebekah, rebakah, rivka, riba, rebekka, rebeckah, reeba, rivca, becha, beccalynn, becca, lyn
bedelia => delia
beecher => beacher
beeman => beaman
bekki => becca, rebeka, rebeca, becky, ree, becha, rivy, reba, rebequa, rifka, riva, rebekah, rebakah, rivka, riba, rebekka, rebeckah, reeba, rivca, rebecca, becka, rebeque, rebeccah
bel => bella, belladonna
belden => beldon
beldon => belden
belicia => isabel, isabelle
belinda => belynda, belle, blinda, lindy, linden, lindi, lin, lynda, linda
bella => annabella, ann, annabel, belle, belva, bel, belladonna, annabelle, anabelle, anabel, anna
belladonna => bel, bella
belle => annabel, anna, anabel, anabelle, annabelle, bella, annabella, ann, belva, belynda, belinda, linda, blinda
belva => bella, belle
belynda => belle, blinda, belinda, linda
ben => benjie, beniamino, benji, benny, bennie, benjamin, benito, rube, reubin, rubin, reuven, reuben, reuby, ruben
bene => bent, benton, benn, benedetto, benedekt, benen, bengt, benner, bennett, benoit, benet, benedict
benedekt => benet, benn, benedetto, benen, bengt, bene, benner, benton, bennett, benoit, bent, benedict
benedetto => benet, benn, benedekt, benen, bengt, bene, benner, benton, bennett, benoit, bent, benedict
benedict => bent, bennett, benner, benoit, benedetto, benn, benet, benton, bene, bengt, benen, benedekt
benen => bent, benet, benn, benedetto, benedekt, bengt, bene, benner, benton, bennett, benoit, benedict
benet => benn, benedetto, benedekt, benen, bengt, bene, bent, benoit, benedict, bennett, benton, benner
bengt => bent, benet, benn, benedetto, benedekt, benen, bene, benner, benton, benoit, bennett, benedict
beniamino => ben, benjamin, benjie, benji, benny, bennie
benita => bente
benito => ben
benjamin => benjie, beniamino, benji, benny, bennie, ben
benji => ben, benjamin, benjie, beniamino, benny, bennie
benjie => ben, benjamin, beniamino, benji, benny, bennie
benn => benet, benedetto, benedekt, benen, bengt, bene, benner, benton, bennett, benoit, bent, benedict
benner => bent, benton, benn, benedetto, benedekt, benen, bengt, bene, bennett, benedict, benoit, benet
bennett => benet, bent, benn, benedetto, benedekt, benen, bene, benner, benedict, benoit, benton, bengt
bennie => ben, benjamin, benny, benji, beniamino, benjie
benny => bennie, ben, benjamin, benjie, beniamino, benji, rube, reubin, rubin, reuven, reuby, reuben, ruben
benoit => benet, bent, benn, benedetto, benedekt, benen, bene, benner, benton, bennett, benedict, bengt
benquasha => quay, quasha
bensen => benson
benson => bensen
bent => benen, bengt, bene, benner, benton, bennett, benedict, benoit, benn, benedetto, benedekt, benet
bente => benita
benton => bent, bene, benner, benn, benedetto, benedekt, benen, bengt, benoit, bennett, benet, benedict
bergan => bergen, bergin
bergen => bergan, bergin, burgess, bergess, burg
bergess => burg, bergen, burgess
bergin => bergan, bergen
berkeley => barklay, barksdale, barkley, barks, berkley, barclay
berkley => barksdale, barkley, barclay, berkeley, barklay, barks
bern => bernadette, bernadete, bernadina, bernadine, barnard, barney, bernie, bernadett, bernard, barnie, bernhardt, berndt, bernhard, berne, bernd, bernardo
bernadete => bernadina, bernadine, bernadette, bern, bernadett, bernie
bernadett => bernadina, bernadine, bernie, bern, bernadete, bernadette
bernadette => bernadete, bernadina, bernadine, bern, bernadett, bernie
bernadina => bernie, bernadett, bern, bernadette, bernadete, bernadine
bernadine => bernie, bernadett, bern, bernadette, bernadete, bernadina
bernard => barney, bern, berndt, bernhard, bernardo, barnie, bernhardt, bernie, berne, bernd, barnard
bernardo => barney, bernard, barnie, bernhardt, bernie, berndt, bernhard, berne, bernd, bern, barnard
bernd => barney, barnie, bernhardt, bernie, barnard, bernard, berndt, bernhard, berne, bernardo, bern
berndt => barney, bernard, barnie, bernhardt, bernie, bern, bernardo, bernhard, berne, bernd, barnard
berne => barney, barnie, bernhardt, bernie, barnard, bernard, bernhard, berndt, bernardo, bernd, bern
bernhard => barney, bernard, barnie, bernhardt, bernie, berne, bernd, bern, berndt, bernardo, barnard
bernhardt => barney, berne, bernd, bern, berndt, bernhard, bernardo, bernard, barnie, bernie, barnard
bernice => berry, bunny
bernie => bernadette, bernadete, bernadina, bernadine, barney, bernadett, bern, bernardo, berne, bernd, berndt, bernhard, bernard, barnie, bernhardt, barnard
berry => bunny, bernice
bert => robertson, bertol, bertil, bertram, bertrem, bobby, robbie, tito, rober, robbins, rubert, robey, robben, berty, róbert, roberto, dob, riobard, rob, rab, robin, bob, robert, dobbs, robinson, rupert, robby, berton, burt, burton, bobbie, ruperta, bertie, robina, robbin, robyn, robinette, berta, roberta, bobbi, berthe, adelberto, bertl, adelbert, adalberto, adalbert, adi
berta => bobby, bert, roberta, robin, bobbi, berthe, bobbie, ruperta, bertie, robina, robbin, robyn, robinette
bertel => adelbert, albert, albrecht, aubert, alby, al, elbert, albertus, alberto, albie, berty, bertie
berthe => roberta, robyn, ruperta, bertie, robina, robbin, robin, bobbi, bobbie, bobby, berta, robinette, bert
berthold => berton, bertholt, bertolt, bertold
bertholt => bertold, berthold, berton, bertolt
bertie => adelbert, al, albert, albrecht, aubert, alby, elbert, albie, albertus, alberto, bertel, berty, bert, roberta, robyn, robin, bobbi, berthe, bobbie, ruperta, robina, robbin, bobby, berta, robinette
bertil => bertrem, bertol, bert, bertram
bertl => adelberto, bert, adalbert, adi, adelbert, adalberto
bertol => bat, tholy, parlan, tolly, bartholomew, bartold, bartlett, bartolomeo, bartel, barth, barton, bertrem, bertil, bertram, bert, barthol
bertold => berthold, berton, bertholt, bertolt
bertolt => bertholt, bertold, berthold, berton
berton => bert, burt, burton, berthold, bertolt, bertholt, bertold
bertram => bertrem, bertil, bert, bertol
bertrem => bertol, bertil, bertram, bert
berty => adelbert, albert, albrecht, aubert, alby, al, elbert, albie, albertus, alberto, bertel, bertie, tito, rubert, bobby, robbins, róbert, roberto, dob, rober, bert, robbie, robey, bob, robert, robertson, dobbs, robinson, rupert, robby, riobard, rob, rab, robin, robben
beryl => bijou
bess => arlise, eliza, isabella, ellie, bettie, beth, elizabeth, arlisa, betsy, isabel, elisabeth, lizzie, libby, ellyzabeth, elise, elsa, betty, aliza, bette, elysia, elsie, elpeth, ilse, elsbeth, elyse, lisbeth, liza, isabelle, lizzy, liz
beth => bethel, annie, bethshaya, shaya, shay, betheny, bethanie, bethannie, bethesda, bethany, liz, arlise, eliza, ellie, bettie, ellyzabeth, bess, elsie, elpeth, bette, elysia, isabella, arlisa, libby, isabelle, lizzy, elise, lisbeth, liza, isabel, elisabeth, elsbeth, elyse, aliza, ilse, betsy, elsa, lizzie, elizabeth, betty
bethanie => bethel, bethany, annie, beth, betheny, bethannie, bethesda
bethannie => annie, betheny, bethany, beth, bethanie, bethesda, bethel
bethany => bethanie, annie, betheny, bethannie, bethesda, beth, bethel
bethel => beth, bethanie, annie, betheny, bethany, bethesda, bethannie
betheny => annie, beth, bethanie, bethannie, bethesda, bethany, bethel
bethesda => annie, betheny, bethany, beth, bethanie, bethannie, bethel
bethshaya => beth, shaya, shay
betsy => arlise, elizabeth, bettie, liz, ellie, liza, isabel, elisabeth, elsbeth, elyse, aliza, ilse, beth, ellyzabeth, bess, elsie, elpeth, bette, elysia, isabella, arlisa, libby, elsa, lizzie, betty, isabelle, lizzy, elise, lisbeth, eliza
bette => liz, arlise, eliza, elizabeth, bettie, beth, arlisa, betsy, isabella, ellie, lizzie, elsa, lisbeth, liza, isabel, elisabeth, elsbeth, elyse, aliza, ilse, ellyzabeth, bess, elsie, elpeth, libby, betty, isabelle, lizzy, elise, elysia
bettie => arlise, betsy, betty, isabelle, lizzy, elise, lisbeth, liza, isabel, elisabeth, elsbeth, elyse, aliza, ilse, beth, ellyzabeth, bess, elsie, elpeth, bette, elysia, isabella, arlisa, libby, elsa, lizzie, elizabeth, ellie, eliza, liz
betty => elizabeth, beth, ellie, eliza, liz, arlise, bettie, elsa, arlisa, elisabeth, elsbeth, betsy, ellyzabeth, elise, elsie, elpeth, lizzie, isabelle, lizzy, bess, libby, elysia, ilse, bette, elyse, aliza, isabella, liza, isabel, lisbeth
bev => beverley, beverly, beverely
bevan => bevis, bevin
beverely => beverly, beverley, bev
beverley => beverly, bev, beverely
beverly => beverley, bev, beverely
bevin => bevan, bevis
bevis => bevan, bevin
bhoomi => bhumi
bhumi => bhoomi
biagio => blis, blase, blaze, blaise
bianca => blanche, blanca, biancha, blancha
biancha => blanca, blancha, blanche, bianca
biddy => bryde, bridget, brigita, gidget, brigetta, brigette, brighid, brigada, brigitte, birgit, brigid, gidgey, britte, britta, brit, brita, bridge, brigida, birgitta, bree, birdie, brie
bienchen => sabine, sabina, sabse, bini, savina, sabiny, biene, saidhbhin
biene => sabiny, savina, bienchen, sabse, sabine, bini, sabina, saidhbhin
bijou => beryl
billie => willamina, wilmette, willy, helma, vilhelmina, wihelma, minny, wilma, willette, wilhemine, billy, minnie, wyla, mina, guillelmine, guillemette, wilhelmina, will, vilma, willa, willie
billy => willamina, minny, wilma, wilhelmina, wyla, willy, wilmette, helma, wihelma, willette, wilhemine, billie, minnie, vilhelmina, guillelmine, guillemette, will, mina, willa, willie, vilma
bin => bingham, binghamton, bing, binghampton
bing => bingham, binghamton, binghampton, bin
bingham => bing, bin, binghamton, binghampton
binghampton => bing, bingham, binghamton, bin
binghamton => binghampton, bing, bin, bingham
bini => saidhbhin, sabine, sabiny, biene, sabina, sabse, bienchen, savina
birdie => bridget, brigita, gidget, brigetta, brigette, brighid, brie, britte, britta, brit, brigada, brigitte, birgit, brigid, gidgey, brita, bridge, brigida, birgitta, bree, biddy, bryde
birgit => bridget, brigita, gidget, brigetta, brigette, brighid, brigada, brigitte, bree, birdie, biddy, brigid, gidgey, brie, britte, britta, brit, brita, bridge, brigida, birgitta, bryde
birgitta => bryde, brigita, bridget, gidget, brigetta, brigette, brigada, brighid, brigitte, birgit, brigid, gidgey, biddy, birdie, brie, britte, britta, brit, brita, bridge, brigida, bree
birk => bourke, burke, burk, birke
birke => burke, burk, bourke, birk
birth => amadi
bjarne => björn, bjorne, bjorn
bjorn => björn, bjorne, bjarne
bjorne => bjorn, bjarne, björn
björn => bjorne, bjorn, bjarne
blachard => blanco, blake, blakeley
blade => bladen
bladen => blade
blain => blaine, blane
blaine => blane, blain
blair => blaire
blaire => blair
blaise => blaze, blase, biagio, blis
blake => blachard, blanco, blakeley
blakeley => blanco, blake, blachard
blanca => blancha, biancha, blanche, bianca
blancha => blanca, biancha, blanche, bianca
blanche => bianca, blancha, biancha, blanca
blanco => blakeley, blake, blachard
blanda => blenda
blane => blaine, blain
blase => biagio, blis, blaze, blaise
blaz => blaze
blaze => blase, biagio, blaz, blis, blaise
blenda => blanda
blinda => linda, belynda, belinda, belle
blis => blaise, blaze, blase, biagio
blithe => blythe
blythe => blithe
bo => beauregard, beau, bowen, bowie
bob => bobby, robbins, róbert, roberto, dob, rober, bert, robbie, robey, robben, berty, robert, robertson, rupert, robby, riobard, rob, rab, robin, dobbs, robinson, tito, rubert
bobbi => bert, roberta, robyn, ruperta, bertie, robina, robbin, robin, berthe, bobbie, bobby, berta, robinette
bobbie => bärbel, barbie, bararella, barbs, babs, barbara, babette, barby, barb, bert, roberta, robyn, ruperta, bertie, robina, robin, bobbi, berthe, bobby, berta, robinette, robbin, barbra
bobby => rubert, robbins, dobbs, robinson, rupert, robby, riobard, rob, rab, robin, bob, berty, róbert, roberto, dob, rober, bert, robbie, tito, robey, robertson, robert, robben, berta, roberta, bobbi, berthe, bobbie, ruperta, bertie, robina, robbin, robyn, robinette
bod => bodony
bodony => bod
bogdana => bohdana
bohdana => bogdana
boni => boniface, bonita, bonny, bonnie
boniface => bonnie, bonny, boni, bonita
bonita => bonny, boniface, boni, bonnie
bonnie => boni, bonita, boniface, bonny
bonny => bonnie, boni, boniface, bonita
bono => boone
boone => bono
booth => boothe
boothe => booth
bordan => borden
borden => bordan
boris => bors, borys
bors => bars, borys, boris
borys => boris, bors
bos => bosworth, boswell
boswell => bos, bosworth
bosworth => bos, boswell
bourke => birk, burke, burk, birke
bowen => bowie, bo
bowie => bo, bowen
brad => bradly, bradley, brady, braedon, braeden, braid, braden, bradney
braden => braid, brad, bradly, bradley, brady, braedon, braeden, bradney
bradley => bradly, braden, braid, brad, brady, braedon, braeden, bradney
bradly => bradley, braden, braid, brad, braeden, bradney, braedon, brady
bradney => braden, braid, brad, bradley, brady, braedon, braeden, bradly
brady => braedon, braeden, bradly, bradley, brad, braid, braden, bradney
braeden => bradly, bradney, braden, braid, brad, bradley, brady, braedon
braedon => bradney, braden, braid, brad, brady, bradley, braeden, bradly
braham => abramio, abra, abram, avrom, ibrahim, avraham, abe, avram, abramo, abie, bram, abran, abraham
brahn => brahni, brahnan
brahnan => brahn, brahni
brahni => brahnan, brahn
braid => brad, bradly, bradley, brady, braedon, braeden, braden, bradney
bram => abramio, avraham, abe, abram, abran, abraham, avram, abramo, abra, abie, avrom, braham, ibrahim, bran, brom
bramwell => branwell
bran => brendan, branford, branden, brandon, brand, brent, brennen, brant, brennan, brom, bram, brenden
brand => brent, bran, brandon, brant, branford, brennen, brennan, branden, brenden, brendan
branden => brendan, brennan, brennen, brand, brent, bran, brant, branford, brandon, brenden
brandon => brendan, brent, bran, brennen, brant, branford, branden, brennan, brand, brenden
brandt => brant
brandy => brann
branford => branden, brendan, bran, brant, brennan, brennen, brandon, brand, brent, brenden
brann => brandy
brant => brendan, branford, branden, brandon, brand, brandt, brent, bran, brennen, brennan, brenden
branwell => bramwell
braxton => brock, brocton
brayden => brayton
brayton => brayden
breanna => brianna, briana, brianne
bree => brigita, bridget, gidget, brigetta, brigette, brigada, brighid, brigitte, birgit, brigid, gidgey, biddy, birdie, brie, britte, britta, brit, brita, bridge, brigida, birgitta, bryde
brenda => brenunda, brynn, brynna
brendan => brenden, branden, brent, bran, brandon, brant, branford, brennen, brand, brennan
brenden => brennen, brendan, brand, brennan, branden, branford, brant, brandon, bran, brent
brennan => branden, brand, branford, brandon, brent, bran, brennen, brant, brenden, brendan
brennen => branden, brand, branford, brandon, brent, bran, brant, brennan, brenden, brendan
brent => brendan, branford, branden, brandon, brand, brentan, bran, brennen, brant, brennan, brenden
brentan => brent
brenunda => brynn, brynna, brenda
bret => bretton, brett
brett => bretton, bret
bretta => brette
brette => bretta
bretton => brett, bret
brew => brewster
brewster => brew
bria => ambria, amber, shawmbria, shawn, ria
briac => brieg
brian => briand, bryant, briant, bryan
briana => breanna, brianna, brianne
briand => bryan, briant, bryant, brian
brianna => breanna, brianne, briana
brianne => briana, breanna, brianna
briant => brian, briand, bryant, bryan
bric => brickand, brick, brice, brigg, bryce
brice => brickand, brick, bric, brigg, bryce, bryse
brick => bric, brice, brigg, bryce, brickand
brickand => brigg, brice, bric, brick, bryce
bridge => brigita, gidget, brigetta, brigette, bridget, brighid, brigitte, brigada, brigid, gidgey, biddy, birdie, birgit, brie, britte, britta, brigida, birgitta, bree, brit, brita, bryde
bridget => brigita, birgit, biddy, gidgey, brigitte, brigada, brighid, gidget, brigetta, brigette, birgitta, bree, brigid, brie, britte, britta, brit, brita, bridge, brigida, birdie, bryde
brie => brigette, brigita, brigetta, bridget, gidget, birdie, brigada, brighid, brigid, gidgey, brigitte, biddy, birgit, brita, bridge, brighton, bright, britte, britta, brit, birgitta, bree, brigida, bryde
brieg => briac
brigada => bridget, brigita, gidget, brigette, brighid, brigida, birgitta, bree, brigid, birdie, birgit, biddy, gidgey, brigitte, brie, britte, britta, brit, brita, bridge, bryde, brigetta
brigetta => bridget, brie, britte, britta, brit, brita, bridge, brigida, birgitta, bree, brigid, birdie, birgit, biddy, gidgey, brigette, bryde, brigita, gidget, brighid, brigada, brigitte
brigette => bridget, britta, brit, brita, bridge, brigida, birgitta, bree, brigid, birdie, birgit, biddy, gidgey, brigitte, brigada, brighid, gidget, brigetta, bryde, brigita, britte, brie
brigg => brickand, brick, brice, bric, bryce
brighid => bridget, brigita, gidget, brigette, birgit, biddy, gidgey, brigitte, brigada, brigid, birdie, bryde, brita, bridge, brigida, birgitta, bree, brie, britte, britta, brit, brigetta
bright => brighton, brie
brighton => brie, bright
brigid => brigita, bridget, gidget, brigetta, brigette, brighid, brigada, brigitte, brie, britte, britta, brit, brita, bridge, brigida, birgitta, bree, birgit, birdie, biddy, gidgey, bryde
brigida => brigita, bridget, gidget, brigetta, brigette, brigada, brighid, brigitte, brigid, gidgey, biddy, birdie, birgit, brita, bridge, birgitta, bree, brie, britte, britta, brit, bryde
brigita => brie, britte, britta, brit, brita, bridge, brigida, birgitta, bree, brigid, birdie, birgit, biddy, gidgey, brigitte, brigada, brighid, bryde, bridget, brigette, brigetta, gidget
brigitte => brigetta, bridget, brigita, gidget, brigette, brighid, britte, britta, brit, brita, bridge, biddy, brigida, birgitta, bree, birgit, birdie, brigid, gidgey, brigada, brie, bryde
brit => brigita, gidget, brigetta, brigette, bridget, birdie, brigitte, brigada, brighid, brigid, brits, britany, biddy, birgit, brita, brie, britte, britta, britney, gidgey, brittyn, britny, britt, brigida, birgitta, bree, bridge, brittany, britannia, brittny, bryde
brita => brigita, gidget, brigetta, brigette, bridget, brighid, brigitte, brigada, brigid, biddy, birdie, birgit, brie, britte, britta, brit, brittyn, brits, britany, britny, britt, gidgey, brittany, brittny, britannia, britney, brigida, birgitta, bree, bridge, bryde
britannia => brita, brittyn, britta, brits, britany, britny, britt, brittany, brittny, brit, britney
britany => brita, brittyn, britny, britt, brittany, britannia, britney, brittny, brit, brits, britta
brites => britta
britney => brita, brittyn, brittany, britta, brits, britany, britny, britt, brit, britannia, brittny
britny => brita, brittyn, britta, brits, britany, brit, britt, brittany, britannia, britney, brittny
brits => britany, brita, brittyn, britny, britt, brittany, britannia, britney, brittny, brit, britta
britt => brita, brittyn, britta, brits, britany, britny, brit, brittany, britannia, britney, brittny
britta => brigita, gidget, brigetta, brigette, bridget, birdie, brigitte, brigada, brites, brighid, brigid, brits, britany, biddy, birgit, brita, brie, britte, brit, gidgey, brittyn, britny, britt, birgitta, bree, bridge, brigida, brittany, britannia, britney, brittny, bryde
brittany => brita, brittyn, britney, britta, brits, britany, britny, britt, brit, brittny, britannia
britte => brigita, gidget, brigetta, brigette, bridget, birdie, brigitte, brigada, brighid, brigid, gidgey, biddy, birgit, brita, bridge, brie, britta, brit, birgitta, bree, brigida, bryde
brittny => brita, brittyn, brittany, britannia, britta, brits, britany, britny, britt, brit, britney
brittyn => brit, britta, brits, britany, britny, britt, brittny, brittany, britannia, britney, brita
brock => braxton, brocton
brocton => braxton, brock
brod => roderick, rick, broderick
broderick => rick, brod, rodrigue, rodrick, ricky, rodd, rod, rodmond, roddy, rodman, rodney, rodrigo, rory, roderich, roderick
brom => bran, bram
bromley => bromwood, bromwell
bromwell => bromwood, bromley
bromwood => bromley, bromwell
bronson => bronwyn, bronwen
bronwen => bronson, bronwyn
bronwyn => bronson, bronwen
brook => brooke, brooks, brookes
brooke => brook, brooks, brookes
brookes => brook, brooke, brooks
brooks => brookes, brook, brooke
broun => bruin, bruno, bruins, brown
brown => bruno, bruin, bruins, broun
bruin => bruno, bruins, brown, broun
bruins => brown, broun, bruno, bruin
bruno => bruins, brown, broun, bruin
bryan => bryant, briant, brian, briand
bryant => bryan, briant, brian, briand
bryce => brick, bric, brickand, bryse, brice, brigg
bryde => birgitta, brighid, gidget, brigetta, brigette, bridget, brigita, britte, brie, brigada, brigitte, gidgey, brigid, birgit, birdie, biddy, bree, brigida, bridge, brita, brit, britta
bryn => brynn
brynn => brynna, bryn, brenunda, brenda
brynna => brynn, brenunda, brenda
bryse => brice, bryce
buck => buckner, bucky, buckley, buckminster
buckley => buckner, bucky, buck, buckminster
buckminster => buckner, bucky, buck, buckley
buckner => bucky, buckley, buck, buckminster
bucky => buckner, buckley, buck, buckminster
bud => buddy, buddie, budd
budd => bud, buddy, buddie
buddie => bud, budd, buddy
buddy => buddie, bud, budd
bunny => berry, bernice
burg => bergen, bergess, burgess
burgess => bergen, bergess, burg
burk => bourke, birk, burke, birke
burke => burk, bourke, birk, birke
burl => burley, burleigh, burle
burle => burleigh, burl, burley
burleigh => burle, burl, burley
burley => burl, byrne, burle, burne, burns, burleigh
burne => burley, burns, byrne
burns => burley, burne, byrne
burt => burton, berton, bert
burton => bert, burt, berton
byram => byran, byron
byran => byron, byram
byrne => burne, burley, burns
byron => byram, byran
bärbel => barbra, babette, barby, barb, bobbie, barbs, babs, bararella, barbie, barbara
cab => cabel, cable
cabel => cab, cable
cable => cab, cabel
caddie => cate, trina, cadie, catlina, cathleen, cat, catriona, catriana, kathie, katharine, kat, katherine, katryn, cathryne, kitty, catrina, catalin, ekaterina, cathy, ky, cayla, catherine, kathryn, katrina, caterina, kate, katie, catie
cadie => cate, catie, catriana, kathie, catalin, cat, catriona, kitty, catrina, caddie, katherine, katryn, kat, cathleen, katharine, katie, kate, caterina, katrina, kathryn, catherine, cayla, ky, cathy, catlina, trina, cathryne, ekaterina
cadmus => cadwell, caldwell
cadrian => rhian
cadwell => caldwell, cadmus
caelyn => cay
cahya => chaim, haym, cahyim, cahyyam, haim
cahyim => haym, cahya, cahyyam, haim, chaim
cahyyam => haym, chaim, cahya, cahyim, haim
cain => kain, caine, caino, cane, kayne, kane, cathan, kaine, keyne, kainen
caine => cain, cane, kayne, kane, cathan, kaine, keyne, kainen, caino, kain
caino => kain, caine, cain
caitlin => kaitlyn, caitlyn, caitrin, kaitlin, catelyn, katelyn, kathleen
caitlyn => catelyn, caitlin, katelyn, kaitlin, caitrin, kaitlyn
caitrin => catelyn, caitlin, katelyn, kaitlin, caitlyn, kaitlyn
cal => cale, caleb, kalin, kalisto, calisto, calista, kalista, kal, calder, caulder, calandra, cally, callie
calandra => cally, callie, cal
calder => caulder, cal
caldwell => cadwell, cadmus
cale => caleb, kalin, cal
caleb => kalin, cale, cal
calista => kalista, kal, cal
calisto => kalisto, cal, kal
call => callia, callee, callie
calla => callan
callan => calla
callee => callia, call, callie
callia => callee, call, callie
callie => calandra, cally, cal, call, callee, callia
callis => callys
cally => callie, calandra, cal
callys => callis
calvin => calvyn, calvinnia, calvino
calvinnia => calvino, calvin, calvyn
calvino => calvinnia, calvin, calvyn
calvyn => calvin, calvinnia, calvino
cam => cammie, cameron, camm, camyron
camelia => cammy, camila, camille, cammilla, mila, kamille, camilla, kamilla, cammie
cameron => camyron, camm, cammie, cam
camila => kamilla, cammie, camelia, cammy, cammilla, mila, kamille, camilla, camille
camilla => kamille, mila, cammilla, camille, cammy, kamilah, camila, kamilla, cammie, camelia
camille => camila, cammilla, cammie, kamilla, camilla, kamille, mila, camelia, cammy
camillo => kamillo, kamil
camm => cameron, camyron, cammie, cam
cammie => cameron, kamilla, camilla, kamille, mila, cammilla, camila, camille, cammy, camyron, camm, cam, camelia
cammilla => camille, mila, camilla, camelia, cammy, camila, kamille, kamilla, cammie
cammy => camelia, camila, camille, cammilla, mila, kamille, camilla, kamilla, cammie
camp => campbell
campbell => camp
camyron => cameron, cammie, cam, camm
candace => kan, kandis, kandice, candi, candys, kandy, candice, candie, candy, candis
candi => kandis, candys, kandy, candice, candie, candy, kandice, candis, kan, candace
candice => candis, candi, kandy, candys, kandis, candie, kandice, candy, kan, candace
candie => candis, candi, candys, kandy, candice, kandis, kandice, candy, kan, candace, carey, cary
candis => candie, candy, kan, kandy, candice, kandice, candys, candi, kandis, candace
candy => candis, candi, candys, kandy, kandice, candice, candie, kandis, kan, candace, carey, cary
candys => candi, kandis, kandy, candice, candie, candy, candis, kandice, kan, candace
cane => kain, kayne, kane, keyne, caine, cain, kaine, kainen, cathan
cannon => kannon, canon
canon => cannon, kannon
canute => knut, knute, cnutte, cnut, knud
cara => karra, carra, karolina, kerrolyn, kerrie, karolyne, carey, karolyna, cary, carolina, kerry, caro, caroline, carol, karo, kari, carry, ceray, karrie, carly, carolyn, carrie, karoline, carolyne, karri, lina, caren, kathy, carin, kathreen, katherine, katie, katarina, katina, karen, kathryn, kate, karyn, caryn, karin, karry, karan, katrin, karon, karina, katrina, cari, kara
carajean => cari
care => kear, keary
caren => katie, katarina, carin, karen, kara, katina, carry, kari, kathreen, kathy, cari, katherine, karina, cara, karon, katrin, katrina, karan, karry, karin, caryn, carrie, karyn, karrie, kate, kathryn
carew => carry, rew, carrie, cary
carey => carrie, carry, kerrie, kerry, cary, kerrolyn, karolina, carolina, caroline, karolyna, karolyne, karo, kari, ceray, karrie, carly, carolyn, carra, karoline, carolyne, karri, lina, cara, carol, caro, candy, candie
cari => kari, keri, kary, kery, carrie, kate, karrie, karyn, caryn, karin, karry, karan, caren, kathy, carin, kathryn, katie, katarina, carry, katina, kara, karen, katrin, karon, cara, karina, katherine, katrina, kathreen, carajean
carin => katrina, karen, kathryn, kate, karrie, karyn, carrie, caryn, katie, katarina, kari, carry, katina, karin, karry, karan, katrin, karon, cara, karina, katherine, kara, cari, kathy, caren, kathreen
carina => karina, carynn, caryn
carissa => karissa, sissa, krissy
carl => karlo, carlyle, karoly, karla, lisle, lyle, carlisle, carlo, karl, carly, carlie, carlton, karel
carla => karol, karla, karola, carlotta, caroll, carol, carlota, carola
carleen => karlie, karly, karlene, carly, carlene, karleen
carlene => carleen, karlie, karly, karlene, carly, karleen
carleton => carlton, charlton
carlie => karlo, karoly, lyle, lisle, carlisle, karl, carlo, carl, carly, carlton, karel, karla, carlyle
carlisle => karlo, karoly, lyle, lisle, karl, carly, carlo, carl, carlie, carlton, karel, karla, carlyle
carlo => karoly, karla, carlisle, karl, carly, carl, carlie, carlton, karel, charley, charlton, chuck, charles, carlos, chico, chick, chaz, chas, charlie, chip, carlyle, karlo
carlos => charlton, chuck, charles, chico, carlo, chick, chaz, chas, charlie, chip, charley
carlota => carol, karola, karol, carola, karla, carla, carlotta, caroll
carlotta => carla, karol, karla, charmayne, charlotte, lotte, charlie, chatzie, charlene, charlayne, lottie, charmaine, karola, caroll, carol, carlota, carola
carlton => karoly, karla, charlton, carleton, carlisle, carlie, carlo, karl, carl, carly, karel, karlo, carlyle
carly => karoly, karleen, karla, lisle, lyle, carleen, karlie, karly, karlene, carlene, carlisle, karl, carlo, carl, kerrolyn, karolina, karolyne, carey, carlie, carlton, karel, carrie, carra, karo, kari, carry, ceray, karrie, carolyn, caroline, carolina, karolyna, kerrie, kerry, cary, karoline, carolyne, karri, caro, lina, cara, carol, karlo, carlyle
carlyle => lisle, lyle, karl, carlo, karla, carlie, carlisle, karlo, karoly, karel, carlton, carly, carl
carmel => carmine, karmel, karmelita, karmen, carmita, carmen, karmelle, carmelita, carmelle
carmelita => carmel, carmen, karmelle, carmine, karmel, karmelita, karmen, carmelle, carmita
carmelle => carmita, carmelita, karmelle, carmen, carmel, karmen, karmelita, karmel, carmine
carmen => carmelle, karmelle, carmine, karmel, karmelita, karmen, carmita, carmel, carmelita
carmine => carmel, carmen, karmelle, karmel, karmelita, carmita, karmen, carmelita, carmelle
carmita => carmelle, carmel, carmen, karmelle, carmine, karmel, karmelita, karmen, carmelita
caro => karolina, kerrie, karolyne, carey, karolyna, cary, carolina, kerry, cara, carol, caroline, karo, kari, carry, ceray, karrie, carly, carolyn, carrie, carra, karoline, carolyne, karri, lina, kerrolyn
carol => caroll, carlotta, carla, karla, carlota, carola, karola, kerrolyn, karolina, karol, kerrie, karolyne, carey, karolyna, cary, carolina, kerry, caro, caroline, carolyne, karri, lina, cara, karo, kari, carry, ceray, karrie, carly, carolyn, carrie, carra, karoline
carola => caroll, carlotta, carla, karla, carlota, carol, karola, karol
carolina => carey, karolyne, karolyna, karo, kari, carry, ceray, karrie, carly, carolyn, carrie, carra, karoline, carolyne, karri, lina, cara, carol, caro, kerrie, karolina, kerry, cary, caroline, kerrolyn
caroline => kerrolyn, carey, karolyne, karolyna, ceray, karrie, carly, carolyn, carrie, carra, karo, kari, carry, karolina, kerry, cary, carolina, carol, caro, kerrie, karoline, carolyne, karri, lina, cara
caroll => carlotta, carla, carola, karol, karla, karola, carol, carlota
carolyn => kerrolyn, karolina, karolyne, carey, carrie, carra, karolyna, karo, kari, carry, ceray, karrie, carly, caroline, cary, carolina, kerrie, kerry, karoline, carolyne, karri, caro, lina, cara, carol
carolyne => kerrolyn, kerrie, karolina, karolyne, carey, karolyna, cary, carolina, kerry, karo, kari, carry, ceray, karrie, carly, carolyn, carrie, carra, karoline, karri, caroline, carol, caro, lina, cara
carra => kerrolyn, karolina, karolyne, carey, karo, kari, carry, ceray, karrie, carly, carolyn, carrie, karolyna, caroline, cary, carolina, kerrie, kerry, karoline, carolyne, karri, caro, lina, carol, ciaran, key, kirwin, kern, kiernan, kerwin, kerr, kieron, ceirnin, kieran, karra, cara, kara
carrie => carry, rew, carew, cary, carey, kerry, kerrie, kerrolyn, karolina, karolyne, ceray, karrie, carly, carolyn, carra, karolyna, karo, kari, caroline, carolina, karoline, carolyne, karri, caro, lina, cara, carol, charisma, carin, kery, keri, kary, cari, caren, karon, kathreen, katherine, kathy, karin, karry, katrina, katie, katarina, katina, karen, kathryn, kate, karyn, kara, karina, caryn, katrin, karan
carry => carrie, cary, carew, rew, kerrie, carey, kerry, karolyna, kerrolyn, karolyne, carra, karo, kari, ceray, karrie, carly, carolyn, karolina, carolina, caroline, karoline, carolyne, karri, lina, caro, cara, carol, charisma, caren, carin, katherine, kathreen, cari, karon, karyn, karry, karin, kathy, kathryn, katarina, katrina, karina, katie, kate, katina, kara, caryn, katrin, karan, karen
cary => carry, rew, carrie, carew, kerry, kerrie, carey, kerrolyn, karolyne, karolyna, candy, candie, carra, carolyne, karri, lina, cara, carol, caro, karolina, karoline, carolina, caroline, karo, kari, ceray, karrie, carly, carolyn
caryn => carynn, karina, cari, caren, carin, kathreen, katherine, kathy, karon, cara, katrina, katie, katarina, kari, carry, katina, karen, kathryn, kate, karrie, karyn, carrie, karin, karry, karan, kara, katrin, carina
carynn => carina, karina, caryn
cascadia => cassie, cassi, cass, cassee
casey => kasey, akaisha
casimir => casmir, kasimir
casmir => casimir, kasimir
caspar => casper
casper => caspar
cass => cassi, cassee, sandra, sandy, cassandra, cassie, cascadia
cassandra => sandy, cassie, cass, sandra
cassee => cassi, cassie, cass, cascadia
cassi => cassee, cascadia, cassie, cass
cassie => sandra, sandy, cascadia, cassandra, cass, cassee, cassi
cat => cathryne, cate, catie, catriana, kathie, catriona, catalin, cathy, cadie, catlina, cathleen, kitty, catrina, caddie, katherine, katryn, katharine, kat, katie, catherine, cayla, ky, kate, caterina, katrina, kathryn, trina, ekaterina
catalin => catie, cathryne, kitty, catrina, caterina, trina, katherine, katryn, cate, katie, kate, katrina, kathryn, catherine, cayla, ky, cathy, cadie, catlina, cathleen, cat, catriona, catriana, kathie, katharine, kat, caddie, ekaterina
cate => cayla, catriona, catriana, kathie, katharine, kat, katherine, katryn, cathryne, katie, kate, caterina, katrina, kathryn, catherine, ky, cathy, cadie, catlina, cathleen, cat, kitty, catrina, catalin, ekaterina, trina, caddie, catie
catelyn => caitlyn, caitrin, kaitlin, caitlin, katelyn, kaitlyn
caterina => ekaterina, trina, cate, catalin, caddie, catie, kathie, katharine, catriana, catriona, catrina, kitty, katryn, kat, katherine, katie, kate, katrina, cathryne, cat, cadie, catlina, kathryn, catherine, cayla, ky, cathy, cathleen
cathan => kainen, kaine, cain, caine, keyne, kain, kayne, kane, cane
catherine => trina, ekaterina, cate, caddie, catie, kathie, katharine, catriana, catalin, catrina, kitty, katryn, catriona, kat, katherine, cathryne, cathleen, cat, cathy, cadie, catlina, katie, kate, caterina, katrina, kathryn, cayla, ky
cathleen => trina, ekaterina, cathryne, cate, catie, catriana, kathie, catriona, catalin, cat, kitty, catrina, caddie, katherine, katryn, katharine, kat, kathryn, catherine, cayla, ky, cathy, cadie, catlina, katie, kate, caterina, katrina
cathryne => catie, catalin, trina, cate, catrina, kitty, caddie, cayla, ky, katryn, katie, kate, caterina, katrina, kathryn, catherine, katherine, kat, katharine, kathie, catriana, catriona, cat, cathleen, catlina, cadie, cathy, ekaterina
cathy => trina, ekaterina, cathryne, cate, catie, caddie, catriana, kathie, catalin, cat, catriona, kitty, catrina, katherine, katryn, kat, cathleen, katharine, catherine, cayla, ky, cadie, catlina, katie, kate, caterina, katrina, kathryn
catie => cadie, catlina, cathleen, cat, catriona, catriana, kathie, katharine, kat, katherine, katryn, cathryne, kitty, catrina, catalin, ekaterina, ky, cathy, kate, caterina, katrina, kathryn, catherine, cayla, cate, katie, caddie, trina
catlina => cate, catie, catriana, kathie, catriona, catalin, cat, kitty, catrina, caddie, katherine, katryn, kat, cathleen, katharine, katie, kate, caterina, katrina, kathryn, catherine, cayla, ky, cathy, cadie, trina, cathryne, ekaterina
catriana => cate, cathryne, catie, ky, cathy, cadie, catlina, cathleen, cat, catriona, kathie, katie, kate, caterina, katrina, kathryn, catherine, cayla, catalin, kitty, catrina, caddie, katherine, katryn, katharine, kat, trina, ekaterina
catrina => catie, catalin, trina, cate, kat, katherine, katryn, cathryne, kitty, katie, kate, caterina, katrina, kathryn, catherine, cayla, ky, cathy, cadie, catlina, cathleen, cat, catriona, catriana, kathie, katharine, caddie, ekaterina
catriona => cate, cathryne, catie, catriana, kathie, catlina, cathleen, cat, catalin, katie, kate, caterina, katrina, cadie, kitty, catrina, caddie, katherine, katryn, katharine, kathryn, catherine, cayla, ky, cathy, kat, trina, ekaterina
caulder => calder, cal
cauvery => cavery
cavery => cauvery
cay => caelyn, caylah, leigh, lee, cayleigh
cayla => cate, trina, ekaterina, caddie, catie, catriana, kathie, katharine, catalin, catrina, kitty, katherine, katryn, catriona, kat, cathryne, cathleen, cat, cathy, cadie, catlina, katie, kate, caterina, katrina, kathryn, catherine, ky
caylah => cay, leigh, lee, cayleigh
cayleigh => lee, leigh, caylah, cay
ceasar => cezar, cesar
cece => cecilia, celia, cicely, sissy, cecelia, cecily, cecil, cicilie, cissy
cecelia => cecilia, sissy, cecily, celia, cicely, cicilie, cecil, cece, cissy
cecero => ciceron, ciro, cicero
cecia => sessi, seesha
cecil => cecily, cece, cissy, celia, cicely, cecilia, sissy, cecelia, cicilie
cecilia => cece, sissy, cecelia, cecily, cicely, cicilie, cecil, celia, cissy
cecily => cicilie, cecil, cissy, cece, cecilia, cecelia, celia, cicely, sissy
cedric => cedrych, cedrick, cerdric
cedrick => cedrych, cedric, cerdric
cedrych => cedric, cedrick, cerdric
ceirnin => kieran, carra, kerry, kirwin, kern, kiernan, kerwin, kerr, kieron, ciaran, key
celena => selina, celene, selly, sena, sellie, sela, selinda, celie, celia, selene, selena, celina, selia
celene => selia, selena, selene, celia, selina, celina, selly, sellie, sena, celena, sela, selinda, celie
celeste => celestina, tina, chelli, sally, chelina
celestina => chelli, celeste, chelina, sally, tina
celia => cissy, cicilie, cecil, cecily, cece, sissy, cecelia, cicely, cecilia, selinda, selly, celene, selia, celina, celena, celie, selena, selene, sela, sellie, sena, selina
celie => selena, selene, sela, sellie, sena, selina, selinda, selia, selly, celia, celena, celina, celene
celina => sellie, celene, selia, sena, celena, sela, selinda, selly, celie, celia, selene, selena, selina
cem => cemal, kemal
cemal => kemal, cem
ceray => karolina, carey, karolyne, carrie, carra, karo, kari, carry, karrie, carly, carolyn, caroline, carolina, karolyna, kerry, cary, kerrie, karoline, carolyne, karri, caro, lina, cara, carol, kerrolyn
cerdric => cedrick, cedrych, cedric
cesar => ceasar, cezar
cezar => ceasar, cesar
chad => chadwick
chadwick => chad
chago => diego, santiago, santi
chaim => cahya, haym, cahyyam, cahyim, haim
chan => chaney, chandler
chance => chauncey, chancellor
chancellor => chauncey, chance
chanda => chandan, chandani
chandan => chanda, chandani
chandani => chandan, chanda
chandler => chan, chaney
chanel => schannel, shannelle, shanel, channel, shanelly, shannel
chaney => chandler, chan
channel => shannelle, schannel, shanel, chanel, shanelly, shannel
chara => roslin, rosette, roselle, rosa, rosabell, rosita, rosey, rosaleen, roanee, rose, rosina, rasia, rosie, roz, rosly, rosalee, rosellen, rosemary, rosemonde, rosmund, rois, rosebud, rozsi, rozamund, rosalie, rosamund, rosella, rosalia, rosemarie, roanna, rosena, charo, rosetta
charisma => carry, carrie
charlayne => charmayne, charlotte, charlie, chatzie, charlene, lottie, charmaine, carlotta, lotte
charlene => lotte, charmayne, charlotte, chatzie, charlayne, lottie, charmaine, carlotta, charlie
charles => carlos, chico, carlo, chick, charlie, chip, chaz, chas, charlton, chuck, charley
charley => chico, carlos, chip, charles, chuck, charlton, chas, chaz, chick, carlo, charlie
charlie => charley, charmayne, charlotte, lotte, chaz, chas, charlton, chuck, charles, chip, carlos, chico, carlo, chick, lottie, charmaine, carlotta, chatzie, charlene, charlayne
charlotte => lotte, charlene, chatzie, charlie, carlotta, charmaine, lottie, charlayne, charmayne
charlton => carlton, carleton, charley, carlos, chico, carlo, chick, chaz, chas, chuck, charlie, chip, charles
charmaine => charmayne, charlotte, charlie, chatzie, charlene, charlayne, lottie, carlotta, lotte
charmayne => charlene, charlayne, lotte, chatzie, charlotte, charlie, carlotta, charmaine, lottie
charo => roslin, rosette, rosa, roselle, rosabell, rosita, rosey, rosaleen, roanee, rose, rosina, rosly, rosalee, rosellen, rosemary, rosemonde, rosmund, rois, rosebud, rozsi, rozamund, rosalie, rasia, rosie, roz, rosena, rosamund, rosemarie, roanna, rosalia, rosella, chara, rosetta
charon => sharry, sharon, sherri, shara, sherry, sharee, sharyn, sharron, sharen, shari
chas => chaz, charlton, chuck, carlos, chico, carlo, chick, charlie, chip, charles, charley
chatzie => charmayne, charlotte, charlene, charlayne, lottie, charmaine, carlotta, charlie, lotte
chauncey => chance, chancellor
chaylen => aylen
chaz => chas, charlton, chuck, carlos, chico, carlo, chick, charlie, charles, chip, charley
chelina => celestina, tina, chelli, celeste, sally
chelle => raquel, shelly, raychel, shelley, rachael, rachel, shellie, chellie, rahel, ray, rah'zell, rachele
chelli => celestina, tina, sally, celeste, chelina
chellie => rachele, raquel, rahel, shelly, ray, shelley, rachael, rachel, shellie, raychel, chelle, rah'zell
chelsea => kelsie, chelsie, xyza, kelsey, kelsy
chelsie => kelsie, chelsea, kelsy, kelsey
cher => sherryl, sheryl, cheryle, cheri, cheryl, cherrie, sheryle, sheri, sherry, cherie, sherryll, sherrill, cherry, cherish
cheri => cher, cheryl, cherish, sherryll, cherry, sherrill, cherrie, sheryle, sheri, sherry, cherie, sherryl, sheryl, cheryle
cherie => cheryle, cheryl, cherish, sherryll, cherry, sherrill, cherrie, sheryle, sheryl, cheri, cher, sherry, sheri, sherryl
cherish => cheryl, sheri, sherry, cherie, sherryll, sherryl, sheryl, cheri, cheryle, cherry, sherrill, cherrie, sheryle, cher
cherrie => sheryl, cheryl, cheryle, cher, sherryll, cherry, sherrill, cherish, sheryle, sheri, sherry, cherie, cheri, sherryl
cherry => cheryl, cherish, cherrie, sheryle, sheri, sherry, cherie, sherryll, sherryl, sheryl, cheryle, cheri, sherrill, cher
cheryl => sheryle, sheri, sherry, cherie, sherryll, sherryl, sheryl, cheryle, cheri, cherish, cherry, sherrill, cherrie, cher
cheryle => cher, cheryl, cherish, sherryll, cherry, sherrill, sheryl, cheri, cherrie, sherryl, cherie, sherry, sheri, sheryle
ches => chester, chet, chess
chess => ches, chester, chet
chester => chet, chess, ches
chet => chess, ches, chester
chevalier => chevie, chevy
chevie => chevy, chevalier
chevy => chevie, chevalier
chiara => clarissa, clairese, clarice, clare, clarisse, clareta, clarrie, claris, claire, claral, claretta, clara, clarette, ciaira, chiarina
chiarina => ciaira, chiara
chick => charlton, chuck, charles, carlos, chico, carlo, chaz, chas, charlie, chip, charley
chico => charlton, chuck, charles, carlos, carlo, chick, chaz, chas, charlie, chip, charley
chidro => isidro
chil => chilton, chilly, chill
chill => chil, chilton, chilly
chilly => chill, chil, chilton
chilton => chilly, chil, chill
chip => charlie, chas, charlton, chuck, charles, carlos, chico, carlo, chick, chaz, chipo, charley
chipo => chip
chlodwig => llewellyn, luthias, lodovico, lewes, ludwig, lewie, luis, lew, lajos, clovis, lu, ludvig, luigi, lou, louie, louis, lewis
chloe => cloe
chloris => cloris
chloé => kloe, clowy, khloe, cloe
chrestian => christian, christiaan, karstan, chris, kristian, karston
chris => christian, karston, chrestian, kristy, christina, krissie, kristian, christine, christeena, kris, christiana, christof, kristopher, kristofer, christopher, karstan, christa, kristi, christie, kristine, kristina, kristin, chrissy, krissy, christophe, kit, kester, kristeena, kirsten, kristen, cristobel, cristoforo, kristof, christiaan
chrissy => christina, christine, kristy, kris, christiana, krissy, christa, kristi, christie, kristine, kristeena, kirsten, kristen, krissie, kristina, kristin, chris, christeena
christa => christina, christine, kristy, kris, christiana, krissy, kristen, krissie, kristina, kristin, chrissy, kristeena, chris, kristi, christie, kristine, kirsten, christeena
christal => cristal, chrystol, cristol, chrystal, crystal, cristel, krystal, kristal, cristale
christeena => kristy, christina, christine, kristen, kristi, krissie, chris, kris, kristeena, kirsten, kristine, krissy, chrissy, kristin, kristina, christiana, christie, christa
christiaan => karstan, chrestian, kristian, christian, chris, karston
christian => christiaan, chrestian, kristian, karston, chris, karstan
christiana => christina, christine, kristy, kris, kristen, kristi, krissie, kristina, kristin, chrissy, christa, christie, chris, kristine, kristeena, kirsten, krissy, christeena
christie => christina, christine, kristy, kris, christiana, krissy, kristine, kirsten, kristen, kristi, krissie, kristina, kristin, chrissy, christa, kristeena, chris, christeena
christina => chrissy, krissy, christa, christie, christeena, chris, christiana, kristine, kristeena, kirsten, kristen, kristi, krissie, kristina, kristin, kristy, kris, christine
christine => kristine, kristeena, kirsten, kristen, kristi, krissie, kristina, kristin, chrissy, krissy, christa, christie, christeena, chris, christiana, kristy, kris, christina
christo => cristo, kristo, christos
christof => chris, kristopher, kristofer, christopher, christophe, kris, kit, kester, cristobel, cristoforo, kristof
christophe => kris, kristof, cristoforo, cristobel, kester, kit, christopher, kristofer, kristopher, chris, christof
christopher => kris, kristofer, kit, kester, cristobel, cristoforo, kristof, kristopher, chris, christof, christophe
christos => christo, cristo, kristo
chrystal => kristal, cristal, chrystol, cristol, crystal, cristel, krystal, christal, cristale
chrystol => cristale, kristal, cristol, chrystal, crystal, cristel, krystal, christal, cristal
chuck => carlos, chico, carlo, chick, chaz, chas, charlton, charlie, chip, charles, charley
ciaira => chiara, chiarina
ciar => ciara, cierra
ciara => ciar, cierra
ciaran => carra, kieran, kerry, kirwin, key, kerwin, kerr, kieron, ceirnin, kern, kiernan
cicely => cecilia, cicilie, cecil, celia, cece, sissy, cecelia, cecily, cissy
cicero => ciro, ciceron, cecero
ciceron => ciro, cicero, cecero
cicilie => cecil, cecily, cece, sissy, cecilia, cissy, celia, cicely, cecelia
ciel => skylar, skye, skyler, schuyler, sky
cierra => ciara, ciar
cilla => priscilla, cyla, silla, priss, prisca, prissy
cindie => cyndi, cinta, cindy, cintia, cinzia, cynthia
cindy => cynthia, cindie, cyndi, cintia, cinzia, cinta
cinta => cinzia, cynthia, cindie, cyndi, cintia, cindy
cintia => cynthia, cindie, cyndi, cindy, cinzia, cinta
cinzia => cynthia, cindie, cyndi, cintia, cindy, cinta
cirano => siranno, syranno, cyrano, syrano, sirano
cirillo => kyril, cyril, cyra, cy
ciro => cicero, ciceron, cecero
cissy => cicilie, cecilia, cicely, cecily, cecelia, sissy, cece, celia, cecil
claiborne => clay, claybourne, clayton, clayborne, claibourne
claibourne => clayton, claiborne, claybourne, clayborne, clay
claire => clarissa, clairese, clarisse, clarice, claral, claretta, clara, chiara, clare, clareta, clarette, clarrie, claris
clairese => clarissa, claral, claretta, clara, chiara, clare, clarisse, clareta, clarette, clarrie, claris, claire, clarice
clan => clancy, clancey
clancey => clancy, clan
clancy => clan, clancey
clara => clairese, clare, clarisse, clarice, clareta, clarette, clarrie, claris, claire, claral, claretta, chiara, clarissa
claral => clairese, clarisse, clarice, claris, claire, claretta, clara, chiara, clare, clareta, clarette, clarrie, clarissa
clare => clairese, clarice, clara, chiara, clarisse, clareta, clarette, clarrie, claris, claire, claral, claretta, clarissa
clarence => claron, clarendon
clarendon => clarence, claron
clareta => claris, clarette, clarrie, clairese, clarisse, clarice, claretta, clara, chiara, clare, claire, claral, clarissa
claretta => clairese, clare, clarisse, clarice, clareta, clarette, clarrie, claris, claire, claral, clara, chiara, clarissa
clarette => claris, clareta, clarrie, clairese, clarisse, clarice, claretta, clara, chiara, clare, claire, claral, clarissa
clarice => chiara, clare, clarisse, clareta, clarette, clarrie, claris, claire, claral, claretta, clara, clairese, clarissa
claris => clareta, clarette, clarrie, clairese, clarisse, clarice, claral, claretta, clara, chiara, clare, claire, clarissa
clarissa => claris, clarrie, clarette, clareta, clairese, clarice, clarisse, clare, chiara, clara, claretta, claral, claire
clarisse => clarice, clareta, clarette, clarrie, claris, claire, claral, claretta, clara, chiara, clare, clairese, clarissa
clark => clarkson, clarke
clarke => clark, clarkson
clarkson => clark, clarke
claron => clarence, clarendon
clarrie => claris, clareta, clarette, clairese, clarisse, clarice, claral, claretta, clara, chiara, clare, claire, clarissa
claud => claudell, klaudia, claudio, claude, claudette, claudius, claudia
claude => claudia, claud, claudell, claudio, klaudia, claudette, claudius
claudell => klaudia, claudio, claude, claudette, claudius, claudia, claud
claudette => claudia, claud, claudell, klaudia, claudio, claude, claudius
claudia => klaudia, claudio, claude, claudette, claud, claudell, claudius
claudio => claudia, claudell, klaudia, claude, claudette, claudius, claud
claudius => claud, claudell, klaudia, claudio, claude, claudette, claudia
claus => nikola, nicky, nicolas, nicholai, nicos, nikki, niko, nikos, nils, nikolaus, nick, klas, nikolai, nixon, nichols, klaas, nichol, niles, nicholas, nicol, miklós, colet, nicolson, nikolie, nickita, klaus, nicklaus, cole, nicola, nikolas, nicodemus, nicolo, colin, nikita, nikolos, nicanor, nicko
clay => claybourne, clayton, clayborne, claibourne, clayland, claiborne
clayborne => claibourne, clayland, clayton, claiborne, claybourne, clay
claybourne => clayton, clayborne, claibourne, claiborne, clay
clayland => clayton, clayborne, clay
clayton => clayborne, claibourne, clayland, claiborne, clay, claybourne
clea => cleon, cleo, cleopatra, clio
cleavon => cleve, clive, cleveland
clem => clements, klemens, clemon, clemens, clement, clemmons
clemens => clem, clements, klemens, clemon, clement, clemmons
clement => clemens, clem, clements, klemens, clemon, clemmons, kliment
clementina => clementyne, clementine
clementine => clementyne, clementina
clements => klemens, clemon, clem, clemens, clement, clemmons
clementyne => clementina, clementine
clemmons => clement, clemens, clem, clements, klemens, clemon
clemon => clement, clemens, clem, clements, klemens, clemmons
cleo => cleon, clea, cleopatra, clio
cleon => cleo, clea, cleopatra, clio
cleopatra => clio, cleo, clea, cleon
cleve => cleveland, clive, cleavon
cleveland => clive, cleavon, cleve
cliff => clifford, clifton
clifford => clifton, cliff
clifton => cliff, clifford
clint => clinton
clinton => clint
clio => cleopatra, cleo, clea, cleon
clive => cleavon, cleve, cleveland
cloe => chloe, chloé
cloris => chloris
clothilde => clotilde, clovis
clotilde => clovis, clothilde
clovis => clothilde, clotilde, lew, llewellyn, luthias, louis, chlodwig, lodovico, lou, lu, ludvig, lewes, ludwig, lewie, luis, lajos, louie, lewis, luigi
clowy => chloé
cnut => canute, knut, knute, cnutte, knud
cnutte => canute, knut, knute, cnut, knud
coalan => kayey
codie => cody
cody => codie
colby => kolby
cole => nicholas, nikola, nicolas, nicky, nicos, nicklaus, nikki, niko, nicholai, nikos, niles, klas, nicol, nicolo, colin, nikita, nikolos, nicola, nikolas, nicodemus, claus, nick, nickita, nicanor, nikolie, nicko, klaas, nichol, colet, nicolson, nichols, nils, nikolaus, miklós, nixon, klaus, nikolai
coleen => colleen, colene
coleman => colman, colemann
colemann => colman, coleman
colene => colleen, coleen
colet => nikola, nicholai, nicos, nicklaus, nikki, niko, nicky, nick, nikos, klas, niles, nicol, claus, nichol, nicanor, nicko, nikolie, nicholas, nicolson, klaas, nichols, cole, nicola, nikolas, nicodemus, nicolo, colin, nikita, nikolos, nikolai, nixon, nils, nikolaus, miklós, nickita, klaus, nicolas
colette => nicolette, nika, nikki, cosette, collette, nikole, nickie, nicky, nichola, nichole, nykki, nykky, nykole, nyky, nikolia, lacole, nicci, nyki, nichelle, nicole, nicoline, nicola
colin => collins, collin, nikola, nicolas, nikki, nicky, nicholai, nicos, nicklaus, niko, nikos, nicholas, nicolson, niles, klas, nicol, cole, nicola, nikolas, nicodemus, nicolo, nikita, nichol, nick, claus, nickita, nicanor, nikolie, nicko, klaas, nichols, nikolos, colet, nils, nikolaus, miklós, nixon, klaus, nikolai
colleen => coleen, colene
collette => cosette, nicolette, nicola, colette, nikki, nikole, nichole, nickie, lacole, nicci, nyki, nichelle, nykole, nyky, nikolia, nykki, nykky, nichola, nicole, nicoline, nicky, nika
collin => collins, colin
collins => colin, collin
colm => mal, malcom
colman => coleman, colemann
colston => colton
colt => kolt, coltin
coltin => kolt, colt
colton => colston
comsy => kosmos, cosmo
con => connie, konrad, conrad, cort, corrado, rad, conroy, kon
conan => conners, o'connor, conor, o'conner, conner, connor
concepcion => connie, concha
concha => connie, concepcion
conncetta => conny
conner => conan, conners, o'connor, conor, o'conner, connor
conners => o'conner, conor, o'connor, conan, conner, connor
connie => concha, konstanzia, constance, con, conrad, constantia, konstanza, constant, constantine, costanza, constanza, konrad, cort, corrado, concepcion, rad, conroy, kon
connor => o'conner, conner, conan, conners, o'connor, conor
conny => conncetta
conor => connor, conner, conan, conners, o'connor, o'conner
conrad => connie, konrad, con, cort, corrado, rad, conroy, kon
conroy => con, conrad, connie, konrad, cort, corrado, kon, rad
constance => konstanzia, connie, constantia, konstanza, constant, constantine, costanza, constanza
constant => konstanzia, costanza, connie, constantine, constance, constanza, constantia, konstanza
constantia => konstanza, constant, costanza, konstanzia, constanza, constance, constantine, connie
constantine => konstantin, constantia, konstanza, constant, connie, constance, costanza, constanza, konstanzia
constanza => constantia, konstanza, constant, konstanzia, costanza, connie, constantine, constance
conway => conwy
conwy => conway
coop => cooper
cooper => coop
cora => cori, corita, corene, coralee, corina, corinna, corinne, corin, coralie, coretta, corissa, corisse
coralee => corina, corinna, corinne, corin, coralie, cori, corissa, cora, corisse, corene, coretta, corita
coralie => cori, corita, coralee, corina, corinna, corinne, corin, coretta, corissa, cora, corene, corisse
corban => korban, qorbin
corbet => corwin, corbin, corwyn, corby, corwan, corbett
corbett => corwan, corbin, corwin, corby, corbet, corwyn
corbin => corbett, corwin, corwan, corwyn, corbet, corby
corby => corwan, corwin, corbin, corwyn, corbet, corbett
cord => cordy, cordas, cordie, cordell
cordas => cordy, cord, cordie, cordell
cordelia => cordy, delia, kordelia
cordell => cordie, cordas, cordy, cord
cordie => cordas, cordy, cord, cordell
cordy => cord, kordelia, cordelia, delia, cordas, cordie, cordell
corene => coretta, corissa, cora, corinne, corin, coralie, cori, corita, coralee, corina, corinna, corisse
coretta => corene, corin, coralie, cori, corita, corissa, cora, corisse, corinne, corinna, corina, coralee
corey => court, kortney, cortie, kurt, kort, courtney, kurtney, corry, correy, corrie, cory, cortney
cori => corita, coralee, corina, corinna, corinne, corin, cora, coretta, corissa, corene, corisse, corinda, coralie
corin => coralie, cori, coretta, corissa, cora, corene, corisse, corinne, corinna, corina, coralee, corita
corina => corinna, corinne, corin, coralie, cori, corissa, cora, corisse, corene, coralee, coretta, corita
corinda => cori
corinna => corinne, corin, coralie, cori, corissa, cora, corisse, corene, corina, coralee, coretta, corita
corinne => corita, coralee, corina, corinna, corin, coralie, cori, coretta, corissa, cora, corene, corisse
corissa => corene, coralee, corina, corinna, corinne, corin, coralie, cori, corita, coretta, cora, corisse
corisse => coralee, corina, corinna, corinne, corin, coralie, cori, corita, coretta, corissa, cora, corene
corita => cora, corene, coretta, corissa, corisse, cori, coralie, corin, corinne, corinna, corina, coralee
cornel => cornelius, cornell
cornelius => cornell, cornel
cornell => cornelius, cornel
corrado => con, conrad, connie, konrad, cort, kon, rad, conroy
correy => corrie, cory, corey, corry
corrie => cory, corey, corry, correy
corry => correy, corrie, cory, corey
cort => corrado, curt, curtis, kurt, kurtis, courtland, cortland, kon, rad, conroy, court, konrad, connie, conrad, con
cortie => court, kurtney, corey, cortney, kort, courtney, kortney, kurt
cortland => cort, courtland, court
cortney => kortney, cortie, kurt, kort, court, corey, kurtney, courtney
corvin => korvin
corwan => corbin, corbett, corwin, corwyn, corbet, corby
corwin => corbin, corwyn, corbet, corby, corwan, corbett
corwyn => corwin, corbin, corbet, corby, corwan, corbett
cory => corrie, correy, corey, corry
cosette => collette, nichola, nichole, nickie, nicky, nicolette, nicole, nicoline, nicola, colette, lacole, nicci, nyki, nichelle, nykole, nyky, nikolia, nykki, nykky, nikki, nikole, nika
cosmo => kosmos, comsy
costanza => constant, konstanzia, constance, connie, constantine, constanza, konstanza, constantia
court => kortney, cortie, kurt, kort, courtney, kurtney, corey, cortney, cortland, courtland, cort
courtland => cort, cortland, court
courtney => court, kurtney, corey, kortney, cortie, kurt, kort, cortney
craig => greg
cree => creighton, creigh, crichton
creigh => crichton, cree, creighton
creighton => creigh, crichton, cree
crichton => creighton, creigh, cree
crisp => crispin, crispus, crispen, crispo, krispen
crispen => crispin, crispus, crispo, crisp, krispen
crispin => crispus, crispo, crisp, krispen, crispen
crispo => crispin, crispus, crispen, crisp, krispen
crispus => crispo, crisp, krispen, crispen, crispin
cristal => cristale, christal, krystal, cristel, crystal, chrystal, cristol, kristal, chrystol
cristale => cristol, christal, chrystol, cristal, kristal, chrystal, crystal, cristel, krystal
cristel => crystal, chrystal, kristal, cristal, chrystol, cristol, krystal, christal, cristale
cristo => christo, kristo, christos
cristobel => kris, christof, chris, kristopher, kristofer, christopher, kit, kester, cristoforo, kristof, christophe
cristoforo => kris, christof, chris, kristopher, kristofer, christopher, kit, kester, cristobel, kristof, christophe
cristol => cristale, kristal, cristal, chrystol, chrystal, crystal, cristel, krystal, christal
crystal => chrystal, kristal, cristal, chrystol, cristol, cristel, krystal, christal, cristale
cullen => culley, cullin
culley => cullen, cullin
cullin => culley, cullen
cunegonda => kunigunde
cunegundes => kunigunde
cunibert => kunibert
cunégonde => kunigunde
curran => curren, currier, currey, currie, currer, curry
curren => curran, currier, currey, currie, currer, curry
currer => currie, currey, currier, curran, curren, curry
currey => currier, curran, curren, curry, currie, currer
currie => currey, currier, curran, curren, currer, curry
currier => curran, curren, curry, currey, currie, currer
curry => currer, currie, currey, currier, curran, curren
curt => cort, kurtis, kurt, curtis, curtys
curtis => cort, curt, kurtis, kurt, curtys
curtys => curtis, curt
cy => kyril, cyrus, cirillo, cyra, cyril
cybele => cybil, cybill
cybil => sibille, sibley, sibyl, sibylle, sybyl, sib, sibbi, sybille, sybilline, sybil, sibeal, sibby, cybill, cybele
cybill => cybele, cybil, sibyl, sibille, sibley, sybil, sybilline, sybyl, sib, sibbi, sybille, sibylle, sibeal, sibby
cyla => silla, priss, prisca, prissy, cilla, priscilla
cyna => cyne, kyne, kyna
cyndi => cynthia, cindie, cinta, cindy, cintia, cinzia
cyne => kyna, cyna, kyne
cynthia => cyndi, cinta, cindy, cintia, cinzia, cindie
cyra => kyril, cirillo, cyril, cy
cyrano => cirano, siranno, syranno, syrano, sirano
cyril => kyril, cirillo, cyra, cy
cyrus => cy
cyzarine => cyzars
cyzars => cyzarine
d'arcy => darcy, darcey, darcie, darci
dartagnan =>  arthus, arte, arta, dartagnan
dabney => davis, devlin, david, davie, davi, dawes, dewey, davey, davidson, davy, dewi, dawson, davyd, dave
dada => danet, danelle, dana, dannett, danice, danna, daniela, danett, danielle, dania, danita, danya, nelle, danae, daniella, nelly
dag => dagget, day, dayton, dagney, daymond, dagny
dagget => day, dag, dayton, dagney, daymond, dagny
dagney => day, dagny, daymond, dayton, dag, dagget
dagny => day, daymond, dagney, dayton, dag, dagget
dahlia => dalia
dailey => daily, daley
daily => dailey, daley
daimen => damian, damon, damien
daine => dakin, dane, daneen, danika
daisey => daisy
daisy => daisey
daiton => day, dayton
dakin => daine, daneen, dane, danika
dal => dalton, dallin, dallen, dallan, dale
dale => dallen, dallan, dallin, dalton, dal
daley => daily, dailey
dalia => dahlia
dallan => dalton, dallin, dale, dallen, dal
dallen => dale, dallan, dalton, dal, dallin
dallin => dale, dal, dallan, dalton, dallen
dalton => dallan, dal, dallin, dale, dallen
damaris => maris
damian => damon, damien, daimen
damien => damian, daimen, damon
damon => damian, daimen, damien
dan => danilo, danielus, daniele, daniel, danni, daniels, danil, danny
dana => nelly, danae, nelle, daniela, danett, danielle, dania, danya, danet, danelle, dannett, danice, danna, dada, danita, daniella
danae => nelle, danice, dada, danet, danelle, danita, danya, dannett, dana, daniella, nelly, dania, danielle, danett, daniela, danna
dane => daine, daneen, dakin, danika
daneen => dakin, dane, daine, danika
danelle => dana, dannett, danice, danna, daniela, danett, danielle, dania, nelly, daniella, danae, nelle, dada, danet, danita, danya
danet => danelle, danita, danya, dada, nelle, danae, daniella, nelly, dania, danielle, danett, daniela, danna, danice, dannett, dana
danett => nelly, dania, danae, nelle, dana, dannett, danice, danna, daniela, danielle, danet, danelle, danya, dada, danita, daniella
dania => nelly, danielle, daniella, danna, daniela, danett, danae, nelle, dana, dannett, danice, dada, danet, danelle, danya, danita
danice => nelly, danae, nelle, daniela, danett, danielle, dania, danet, danelle, dana, dannett, danna, danya, dada, danita, daniella
daniel => danny, danielus, dan, danilo, daniels, danil, daniele, danni
daniela => nelly, dania, danae, nelle, dana, dannett, danice, danna, danett, danielle, danet, danelle, danya, dada, danita, daniella
daniele => danny, danielus, dan, danilo, danil, daniel, danni, daniels
daniella => dania, nelly, danae, nelle, dada, danet, danelle, danita, danya, danielle, danett, daniela, danna, danice, dannett, dana
danielle => nelly, dania, daniella, danae, nelle, dana, dannett, danice, danna, daniela, danett, danet, danelle, danya, dada, danita
daniels => danny, danilo, danielus, dan, daniel, danni, danil, daniele
danielus => danil, daniele, daniel, danni, daniels, dan, danilo, danny
danika => daneen, dakin, dane, daine
danil => danielus, danny, dan, danilo, daniele, daniel, danni, daniels
danilo => danny, daniels, dan, danielus, danil, daniele, daniel, danni
danita => dana, dannett, danice, danna, daniela, danett, danielle, danya, danelle, danet, dada, nelle, danae, daniella, nelly, dania
danna => nelly, dania, danae, nelle, daniela, danett, danielle, danet, danelle, dana, dannett, danice, danya, dada, danita, daniella
dannett => nelly, danae, nelle, daniela, danett, danielle, dania, danya, danet, danelle, dana, danice, danna, dada, danita, daniella
danni => danny, danilo, danielus, dan, daniels, danil, daniele, daniel
danny => daniele, daniel, danni, daniels, dan, danil, danielus, danilo
danya => nelly, daniella, danae, nelle, dada, danet, danelle, danita, dania, danielle, danett, daniela, danna, danice, dannett, dana
daphne => daphnis
daphnis => daphne
dara => darra
darby => derby
darcey => darci, darcie, d'arcy, darcy
darci => darcey, darcie, darcy, d'arcy
darcie => darci, darcey, darcy, d'arcy
darcy => d'arcy, darci, darcie, darcey
dare => darlin, darlene, darlynn, darla, darlen, darren, darryn, darrin, darin, darleen
daria => darine
darian => darien, dario, darius
darien => darian, dario, darius
darin => darryn, dare, darren, darrin
darine => daria
dario => darien, darian, darius, darry
darius => darien, dario, darian
darla => darlin, darlene, darlynn, dare, darlen, darleen
darleen => darlin, darlene, darlynn, darlen, darla, dare
darlen => darleen, darlin, darlene, darlynn, dare, darla
darlene => dare, darla, darlen, darleen, darlin, darlynn
darlin => dare, darla, darlen, darleen, darlene, darlynn
darlynn => darlin, darleen, darlen, darla, dare, darlene
darra => dara
darrel => darryl, daryll, daryl, darryll
darren => dare, darryn, darrin, darin
darrin => dare, darren, darryn, darin
darry => dario, dora
darryl => darrel, daryll, daryl, darryll
darryll => darryl, daryll, daryl, darrel
darryn => dare, darren, darrin, darin
dartagnan => dartagnan
darwin => darwyn
darwyn => darwin
daryl => darryll, darrel, daryll, darryl
daryll => darrel, darryl, darryll, daryl
davan => davida
dave => dabney, dawes, david, davie, dewey, davey, davyd, dawson, dewi, davy, davidson, davi, davis, devlin
davey => dawes, davie, dabney, devlin, david, dewey, dewi, davy, dave, davis, davidson, davyd, dawson, davi
davi => dabney, david, davie, devlin, dawson, dewi, davy, dave, davis, davyd, davidson, dewey, davey, dawes
david => dabney, dawes, davy, dave, devlin, davi, davie, dewey, davey, davidson, davyd, dawson, davis, dewi
davida => davan
davidson => dawes, davie, david, dewi, davy, dave, davis, davyd, davi, dewey, dawson, davey, devlin, dabney
davie => dabney, dawes, dewey, davey, davyd, dawson, davis, dewi, davidson, dave, devlin, david, davy, davi
davina => davine, davita
davine => davita, davina
davis => dabney, dawes, davie, david, dewey, davey, davidson, davyd, dawson, davi, dewi, davy, dave, devlin
davita => davina, davine
davy => dawes, david, davie, dewey, davey, davyd, dawson, dewi, davidson, davi, dave, davis, devlin, dabney
davyd => dawes, davie, david, dewi, davy, dave, davis, davi, davidson, dewey, dawson, davey, devlin, dabney
dawes => dewey, davey, davidson, davyd, dawson, davis, davy, dave, devlin, david, davie, dabney, dewi, davi
dawson => dawes, davie, david, dewi, davy, dave, davis, dewey, davidson, davyd, davi, davey, devlin, dabney
day => dagny, daymond, dagney, dayton, dag, daiton, dagget
daymond => day, dagny, dagney, dayton, dag, dagget
dayton => day, dagny, daymond, dagney, daiton, dag, dagget
deacon => declan
deana => deena, deanne, deane, deanna
deandra => diana, diane, diahann, dyanne, diandra, dyan, dionne, diantha, di
deane => deena, deanne, deana, deanna
deanna => deana, deena, deanne, deane, dina, dinah
deanne => deanna, deana, deena, deane
deb => debo, debra, debbie, devorah, debrah, deborah, devora, debby
debbie => debo, debby, debrah, debra, deb, devora, devorah, deborah
debby => debo, debra, debrah, devorah, debbie, devora, deb, deborah
debo => deborah, deb, devora, debra, debby, debrah, devorah, debbie
deborah => debo, debra, devorah, debrah, deb, devora, debbie, debby
debra => debby, debo, deborah, deb, devora, debbie, devorah, debrah
debrah => debbie, devorah, debra, deborah, deb, devora, debo, debby
declan => deacon
dee => deedra, deedee, deirdre, deirdra, dierdre, dierdra
deedee => deedra, dee, deirdre, deirdra, dierdre, dierdra
deedra => deedee, dee, deirdre, deirdra, dierdre, dierdra
deena => deanne, deane, dina, dinah, deana, deanna
deirdra => deedra, deedee, dee, deirdre, dierdre, dierdra
deirdre => deedra, deedee, dee, deirdra, dierdre, dierdra
deja => dejah
dejah => deja
del => delmar, delmer, delmore
delaina => delaney, delaine
delaine => delaney, delaina
delana => delanna
delaney => delaina, delaine
delanna => delana
deleep => dilip
delia => cordy, bedelia, cordelia, kordelia
delila => lilah, delilah, lila
delilah => delila, lilah, lila
dell => adella, adela, della
della => eda, ady, addie, adalheld, adelaide, adalee, adara, adah, adalia, adelle, adailia, elle, adele, ellie, adeline, aline, etta, dell, adella, adela
delmar => delmer, del, delmore
delmer => delmar, del, delmore
delmore => del, delmar, delmer
delores => dora, addolorata, deloris, dolores, dorrie
deloris => dolores, dorrie, addolorata, dora, delores
demelza => demie
demeter => dmitry, dimitry, dimity, demitiri, demetrius, dimitri, dmitri
demetrius => dmitry, dimitry, dimity, demitiri, demeter, dimitri, dmitri
demie => demelza
demitiri => dimity, demetrius, demeter, dimitri, dmitry, dimitry, dmitri
den => ogden, denny, oggie
dena => denna
denby => denim, denholme, denholm
deneise => denyse, denyce, denise, deniese, denice, deniece, dennice
denholm => denby, denim, denholme
denholme => denim, denby, denholm
denice => deneise, denyse, denyce, deniese, dennice, denise, deniece
deniece => deneise, denyse, denyce, denice, denise, dennice, deniese
deniese => dennice, deneise, denyse, denyce, denise, deniece, denice
denim => denholme, denholm, denby
denis => tennis, dennys, dennit, dennis, dionysus, denzil, denzel, denit, denny, dennison, denniston, denzell, dion, tennyson
denise => dennice, deneise, denyse, denyce, deniese, deniece, denice
denit => tennis, dennys, denniston, denzell, dennit, dennis, dionysus, denzel, denzil, denis, denny, dennison, dion, tennyson
denna => dena
dennice => denice, deniese, denise, denyce, denyse, deneise, deniece
dennis => tennyson, dennys, denis, denit, denny, dennison, denzel, denzil, denniston, denzell, dionysus, dion, dennit, tennis
dennison => tennis, dennys, denzell, dennit, dennis, dionysus, denzel, denzil, denniston, denis, denit, denny, dion, tennyson
denniston => dennys, dion, denit, denny, dennison, denzell, dennit, dennis, dionysus, denzel, denzil, denis, tennyson, tennis
dennit => tennyson, dennys, dion, denis, denit, denny, dennison, denzel, denzil, denniston, denzell, dennis, dionysus, tennis
denny => tennis, dennison, dennys, denniston, denzell, dennit, dennis, dionysus, denzel, denzil, denis, denit, dion, ogden, oggie, den, tennyson
dennys => tennis, denniston, denzell, dennit, dennis, dionysus, denzel, denzil, denis, denit, denny, dennison, dion, tennyson
denyce => denise, deniese, denice, deniece, dennice, denyse, deneise
denyse => denyce, denise, deniese, denice, deniece, dennice, deneise
denzel => tennis, tennyson, dennys, denis, denit, denny, dennison, denzell, dennit, dennis, dionysus, denzil, denniston, dion
denzell => tennyson, dennys, dion, denit, denny, dennison, denzel, denzil, denniston, denis, dennit, dennis, dionysus, tennis
denzil => tennis, tennyson, dennys, denis, denit, denny, dennison, denzell, dennit, dennis, dionysus, denzel, denniston, dion
der => derry, derych, derrik, dirk, derek, derrick, derex, derik, derick
derby => darby
derek => derik, derrick, derry, derych, der, derick, derex, derrik, dirk
derex => der, derry, derych, derik, derek, derrick, derick, derrik, dirk
derick => derych, derex, derrik, derek, derrick, derik, dirk, derry, der
derik => derek, der, derry, derych, derex, derrick, derrik, derick, dirk
dermot => kermit
derrick => derych, der, derik, derick, derex, dirk, derry, derek, derrik
derrik => derych, der, derick, derik, dirk, derex, derry, derrick, derek
derry => derych, derex, der, derik, derick, derrick, derek, dirk, derrik
derwood => durwin, durward, durwald, durwood
derych => derrik, dirk, derek, derrick, derick, derik, derry, der, derex
des => desmond, destinee, destiny, destini, desi
desi => desirae, desiri, desiree, desiderio, destinee, destiny, destini, desideria, desmond, des
desideria => desi, desirae, desiri, desiree
desiderio => desi
desirae => desiri, desiree, desi, desideria
desiree => desirae, desiri, desi, desideria
desiri => desiree, desi, desideria, desirae
desmond => esmund, esmond, desmund, des, desi
desmund => desmond, esmond, esmund
destinee => desi, des, destiny, destini
destini => destinee, des, destiny, desi
destiny => destini, destinee, des, desi
desty => modestine, modesta, modeste, modestia, modesty
devan => devante, devi
devante => devan, devi
devi => devante, devan
devin => devon
devlin => dabney, dawes, david, davie, dewey, davey, davidson, davi, davyd, dawson, davis, dewi, davy, dave
devon => devin
devora => debby, debo, debra, debbie, devorah, debrah, deborah, deb
devorah => debby, debrah, debra, deborah, deb, devora, debbie, debo
dewey => dawes, davie, dabney, devlin, david, davey, dewi, davy, dave, davis, davi, davidson, davyd, dawson
dewi => davie, david, davey, davidson, davyd, dawson, davi, davy, dave, davis, dewey, devlin, dabney, dawes
di => diantha, diana, diane, dionne, dyan, diahann, dyanne, diandra, deandra
diahann => diana, di, diane, dionne, deandra, dyanne, diandra, dyan, diantha
diana => dyanne, diahann, dyan, dionne, diane, di, deandra, diandra, diantha
diandra => diane, diana, dionne, deandra, diahann, dyanne, dyan, diantha, di
diane => diana, di, diandra, dyanne, diahann, dyan, dionne, deandra, diantha
diantha => di, diana, diane, dionne, dyan, diahann, dyanne, diandra, deandra
diarria => didi
dick => rich, richmond, dicky, rick, richard, ricard, rich rickie, richman, rickward, dickie, rickert, ricardo, richardson, ritchie, rickard, ricky, rikkert, riocard, rocco, ricker, richerd
dicken => dickinson, dickenson, dix, dixon, dickens
dickens => dickinson, dixon, dix, dickenson, dicken
dickenson => dickinson, dickens, dixon, dix, dicken
dickie => richmond, dicky, richerd, rich, richard, rich rick, rickie, dick, ricard, rikkert, ricky, rocco, ricker, rickard, riocard, richman, rickward, richardson, ritchie, rickert, ricardo
dickinson => dickens, dixon, dix, dickenson, dicken
dicky => rikkert, rocco, rich rick, richman, rickward, dickie, rickert, ricardo, richardson, dick, richerd, riocard, ritchie, ricker, rickard, rickie, richard, ricard, ricky, richmond, rich
didi => diarria
diego => santiago, chago, santi
dierdra => deedra, dierdre, deirdra, deirdre, dee, deedee
dierdre => deedra, deedee, dee, deirdre, deirdra, dierdra
dilip => deleep
dillan => dillon, dylan
dillon => dylan, dillan
dimitri => dimity, demitiri, dmitri, dmitry, dimitry, demetrius, demeter
dimitry => demetrius, demeter, dmitri, dmitry, dimity, dimitri, demitiri
dimity => dimitri, demitiri, demetrius, demeter, dmitri, dmitry, dimitry
dina => deanna, dinah, deena
dinah => deena, deanna, dina
dion => tennyson, tennis, denniston, denzell, dennit, dennis, dionysus, denzel, denzil, denis, denit, denny, dennison, dennys, dionne, dione
dione => dion, dionne
dionne => diana, di, diane, diandra, dyanne, diahann, dyan, deandra, dione, dion, diantha
dionysus => tennis, tennyson, denzel, dennys, denis, denit, denny, dennison, denzil, denniston, dion, dennis, denzell, dennit
dirk => derych, der, derrik, derik, derek, derrick, derick, derex, derry
divia => divya
divya => divia
dix => dickinson, dickens, dixon, dickenson, dicken
dixi => dixon, dixie, dixy
dixie => dixy, dixi, dixon
dixon => dickinson, dickens, dix, dickenson, dixi, dixie, dixy, dicken
dixy => dixon, dixie, dixi
dmitri => dmitry, dimitry, dimity, dimitri, demeter, demetrius, demitiri
dmitry => demetrius, demeter, dimitri, dmitri, dimitry, dimity, demitiri
dob => robbins, róbert, roberto, bobby, dobbs, robinson, rupert, robby, riobard, rob, rab, robin, bob, berty, rober, bert, robbie, tito, robey, robert, robertson, robben, rubert
dobbs => robey, rubert, bobby, robbie, roberto, dob, robbins, robertson, tito, rober, robben, róbert, berty, rupert, robby, riobard, rob, rab, robin, bob, bert, robinson, robert
dolce => dulcie, dulsie, dulcinea, dulcea, dulce
dolf => randl, randal, rand, randle, ranulf, randolph, randall, randy, randie, randell, rankin, dolph, ran, randolf
dolley => dotson, dotty, dot, dorothy, dolly, dottie, dorothea
dolly => dottie, dotson, dot, dolley, dorothy, dotty, dorothea
dolores => dorrie, addolorata, deloris, dora, delores
dolph => randl, randal, rand, randle, ran, randell, randolph, randall, randy, randie, ranulf, dolf, rankin, rodolf, rudi, rudolf, rudy, rolf, rodolfo, rudolph, rolph, rollo, rodolphe, rudie, raoul, rollin, randolf
dom => domenico, nick, dominik, dominick, dominica, dominique, dominic, dominy, domingo
domenico => dominick, dominik, nick, dom, dominique, dominica, dominy, dominic, domingo
domina => donna, madonna, dona
dominga => inga
domingo => dominick, dominica, dominy, dominic, dominique, domenico, dom, nick, dominik
dominic => dominik, dominique, domingo, dominica, dominy, domenico, dominick, dom, nick
dominica => dominik, domingo, dominique, dominy, dominic, domenico, dominick, dom, nick
dominick => dominik, domenico, dominica, dominique, dominic, dominy, domingo, dom, nick
dominik => nick, dominica, dominy, dominic, dominick, domenico, dom, domingo, dominique
dominique => dominik, nick, dom, dominick, dominic, domingo, dominica, dominy, domenico
dominy => dominik, domingo, dominic, dominique, dominica, domenico, dominick, dom, nick
domokos => domonkos, domos
domonkos => domokos, domos
domos => domokos, domonkos
don => donne, donny, donnie, donaldson, donald, donal, donghal
dona => donna, domina, madonna
donahue => donovan, donner, donnelly, donovon, donnell, donnel
donal => donald, donne, donny, donnie, donaldson, don, donghal
donald => donne, donny, donnie, donaldson, don, donal, donghal
donaldson => donghal, donal, donald, donne, donny, donnie, don
donatien => donato
donato => donatien
donghal => donal, donald, donne, donny, donnie, donaldson, don
donna => domina, madonna, dona
donne => donny, donnie, don, donaldson, donald, donal, donghal
donnel => donovan, donner, donnelly, donovon, donnell, donahue
donnell => donovan, donner, donnelly, donovon, donahue, donnel
donnelly => donovan, donner, donnel, donahue, donnell, donovon
donner => donnelly, donovan, donnel, donahue, donnell, donovon
donnie => donghal, donal, donald, donne, donny, don, donaldson
donny => donnie, don, donaldson, donne, donald, donal, donghal
donovan => donovon, donnell, donahue, donnel, donner, donnelly
donovon => donovan, donner, donnelly, donnell, donahue, donnel
dora => addolorata, deloris, dolores, dorrie, dori, dore, eudor, pan, dorothy, pandora, dory, theodora, theodore, dorothea, endora, fedora, thedora, tedra, theodosia, feodora, theone, theophilia, theda, theophania, theora, teodora, delores, darry
dore => doris, dorris, dorice, dory, dora, dori
doreen => dorine, dorene
dorene => doreen, dorine
dori => dore, doris, dorris, dorice, dory, dora
dorian => dorien, dory, dorrian, dorie, dorrien
dorice => dore, dori, dory, dorris, doris
dorie => dorien, dory, dorian, dorrian, dorrien
dorien => dory, dorrian, dorie, dorrien, dorian
dorine => doreen, dorene
doris => dori, dorris, dore, dorice, dory
dorothea => dotty, theodore, pan, pandora, dora, endora, dory, theodora, dolly, dorothy, dolley, dot, dotson, dottie
dorothy => dorothea, dotson, dotty, dot, dolley, dolly, dottie, pan, pandora, dora, endora, dory, theodora, theodore
dorrian => dorie, dorrien, dorian, dory, dorien
dorrie => delores, dolores, dora, deloris, addolorata
dorrien => dorien, dory, dorrian, dorie, dorian
dorris => dorice, dore, dory, dori, doris
dorset => dorsey
dorsey => dorset
dory => dorice, dorien, dorian, dorrian, dorie, dorrien, doris, dorris, dori, dore, dorothy, pandora, dora, endora, theodora, theodore, dorothea, pan
dot => dotson, dotty, dolley, dorothy, dolly, dottie, dorothea
dotson => dotty, dot, dolley, dorothy, dolly, dottie, dorothea
dottie => dolly, dotson, dotty, dot, dolley, dorothy, dorothea
dotty => dotson, dot, dolley, dorothy, dolly, dottie, dorothea
doug => dougie, douglas, dugald, dugan, dougal, douglass
dougal => douglass, dugan, dugald, douglas, dougie, doug
dough => duff
dougie => douglas, dugald, dugan, dougal, douglass, doug
douglas => doug, dougie, dugald, dugan, dougal, douglass
douglass => doug, dougie, douglas, dugald, dugan, dougal
doyl => doyle
doyle => doyl
doyt => dwighte, dwyght, dwight, dwite, dwyghte, dwyte
drew => andreas, andrew, andres, andrea, andy, anders, andrews, andries, andrei, andrys, andré, andros, andrey, andie, dru
dru => drew
duane => dwayne, dwane, duwayne, wayne, dwaine, dwain
dud => dudly, duddy, dudley
duddy => dudley, dud, dudly
dudley => dud, dudly, duddy
dudly => dud, dudley, duddy
duff => dough
dugald => dugan, dougal, douglass, douglas, dougie, doug
dugan => dougal, douglass, dugald, douglas, dougie, doug
duke => marmaduke
dulce => dolce, dulcie, dulcea, dulcinea, dulsie
dulcea => dulsie, dulcinea, dulce, dolce, dulcie
dulcie => dulcea, dulcinea, dulce, dolce, dulsie
dulcinea => dulce, dolce, dulcie, dulsie, dulcea
dulsie => dulcinea, dulce, dolce, dulcie, dulcea
dun => duncan, dunc
dunc => duncan, dun
duncan => dun, dunc
dunn => dunne
dunne => dunn
dunston => dustan, dusty, dustin
duran => durand, durant, durandt
durand => durant, duran, durandt
durandt => durant, duran, durand
durant => duran, durand, durandt
durwald => durwood, durwin, durward, derwood
durward => durwald, durwood, durwin, derwood
durwin => derwood, durward, durwald, durwood
durwood => durwin, durward, durwald, derwood
dustan => dusty, dustin, dunston
dustin => dunston, dustan, dusty
dusty => dustan, dunston, dustin
duwayne => duane, dwaine, dwain, wayne, dwayne, dwane
dwain => dwaine, duane, wayne, duwayne, dwane, dwayne
dwaine => dwain, duane, wayne, duwayne, dwane, dwayne
dwane => duane, dwaine, dwain, duwayne, wayne, dwayne
dwayne => duane, dwaine, dwain, wayne, dwane, duwayne
dwenn => dwennon
dwennon => dwenn
dwight => dwyghte, doyt, dwyght, dwyte, dwite, dwighte
dwighte => doyt, dwyghte, dwite, dwyght, dwyte, dwight
dwite => dwyghte, doyt, dwighte, dwyght, dwyte, dwight
dwyght => doyt, dwyte, dwyghte, dwight, dwite, dwighte
dwyghte => dwight, dwite, dwighte, dwyght, dwyte, doyt
dwyte => dwyght, dwyghte, dwight, dwite, dwighte, doyt
dyan => diana, di, diane, dionne, deandra, diandra, dyanne, diahann, diantha
dyanne => diana, di, diantha, diane, dionne, deandra, diahann, diandra, dyan
dylan => dillan, dillon
dyna => dynean
dynean => dyna
eammon => eamon, edmund, ammon, amon
eamon => edmund, ammon, eammon, amon
earl => erie, earland, erlene, earleen, early, erroll, earle, errol, erleen
earland => earl, erie, erlene, earleen, errol, early, erroll, earle, erleen
earle => errol, erleen, earl, erroll, erie, earland, erlene, earleen, early
earleen => earl, erie, earland, erlene, errol, early, erroll, earle, erleen
early => earl, erie, errol, earland, erlene, earleen, erroll, earle, erleen
earnest => ernst, ernest, erny, ernesto, erni, ernie
earnestine => ernesta, ernestine, erna, ernie
eban => eben, ebenezer
eben => eban, ebenezer
ebenezer => eben, eban
eberardo => eberhard, everard, everett, everet, eberhart
eberhard => abelard, abelardo, everard, eberardo, everet, eberh everett
eberhart => everett, eberardo, eberhard, everard, everet
ebonee => ebonie, ebony
ebonie => ebony, ebonee
ebony => ebonee, ebonie
ed => eduardo, neddy, neddie, edvard, edwardo, teddie, edward, eddy, eduard, edwards, ned, edwardson, edgar, edgerton, edgarton, edger, teddy, edmund, eddie, edmond, ted, ede, edgardo
eda => aline, adah, della, adalee, adelaide, adara, adailia, elle, adele, ellie, ady, addie, adalheld, adalia, adelle, etta, adeline, adela, edda
edan => edie, eddy, eddie, eden
edda => edita, edie, edythe, edyth, edith, edithe, editha, eda
eddie => eddy, edie, edan, neddy, edwards, edwardson, ned, teddy, ede, ed, eduardo, neddie, edvard, edwardo, eduard, edmund, edmond, ted, teddie, edward, eden
eddy => edie, neddy, eduardo, ted, edwards, ed, edwardson, neddie, edvard, teddie, edward, eduard, edwardo, ned, edan, eddie, eden
ede => edmund, eddie, edmond, ted, ed, teddy
eden => edan, edie, eddy, eddie
edgar => adair, edgarton, edgerton, edger, ed, edgardo
edgardo => edgarton, edgar, edgerton, ed, edger
edgarton => edgerton, edgar, edger, ed, edgardo
edger => edgar, edgarton, edgerton, ed, edgardo
edgerton => edgarton, edgar, edger, ed, edgardo
edie => edita, edyth, edythe, edda, edith, edithe, editha, edan, eddie, eddy, eden
edina => edwina, edwynna, edwyna, edwinna
edison => edyson, edson
edita => edie, edythe, edda, edith, edithe, editha, edyth
edith => edita, edie, edythe, edda, edyth, edithe, editha
editha => edithe, edyth, edita, edie, edythe, edda, edith
edithe => editha, edita, edie, edythe, edda, edith, edyth
edmond => ted, ede, ed, edmund, eddie, teddy
edmund => eamon, ammon, amon, eammon, ede, ed, teddy, eddie, edmond, ted
edson => edyson, edison
eduard => neddy, eduardo, ted, edwards, ed, edwardson, eddy, ned, neddie, edvard, teddie, edward, eddie, edwardo
eduardo => edward, teddie, edwardo, edvard, eddie, ned, edwards, ted, eduard, eddy, neddie, neddy, edwardson, ed
edvard => neddy, edwards, ed, edwardson, eddy, ted, ned, eduardo, teddie, edward, eddie, neddie, edwardo, eduard
edward => neddy, edwards, ed, edwardson, eddy, ted, ned, eduardo, neddie, edvard, teddie, edwardo, eddie, eduard
edwardo => edwardson, neddy, ted, edwards, ed, eddy, eduard, ned, eduardo, teddie, edward, neddie, edvard, eddie
edwards => neddy, eduardo, neddie, eddie, edvard, teddie, edward, eddy, eduard, ted, edwardo, ed, ned, edwardson
edwardson => ned, edwardo, neddy, neddie, eddie, edvard, ed, teddie, edward, eddy, eduard, ted, edwards, eduardo
edwin => edwyn
edwina => edwinna, edina, edwynna, edwyna
edwinna => edwina, edwynna, edina, edwyna
edwyn => edwin
edwyna => edwina, edina, edwynna, edwinna
edwynna => edwina, edina, edwyna, edwinna
edyson => edison, edson
edyth => editha, edythe, edie, edda, edith, edithe, edita
edythe => edita, edyth, edie, edda, edith, edithe, editha
effie => teppi, efterpi
efrem => ephraim, ephrem
efterpi => effie, teppi
egan => egil, egon
egil => egon, egan
egon => egil, egan
egor => zhorka, georg, georgius, georges, yuri, giorgio, yura, jürgen, yoyi, giorgis, georgi, yurik, jiri, jorrin, jurek, jurgi, jorgen, yegor, jorges, georgio, yurchik, georgie, jerzy, yusha, jur, jurik, seiorse, geordie, jurgen, goran, yurko, juro, george, jeorg, georgy, jorge
eileen => eilen, avaline, evel, evilio, avalina, ilene, evelyn, evalyn, aveline, evalina, avelina, evelina, evette, eveline, alene
eilen => eileen, avelina, evalyn, alene, aveline, ilene, evelyn, evalina, evette, eveline, evelina, avaline, evel, evilio, avalina
ekaterina => catie, katie, kate, trina, cate, caddie, catherine, kathryn, katrina, caterina, catalin, catrina, kitty, cathryne, katryn, katherine, kat, katharine, kathie, catriana, catriona, cat, cathleen, catlina, cadie, cathy, ky, cayla
el => elouise, elo, eloise
el'azar => lazre, lazar, lázár, lazaro, lazarus, laszlo
elaina => laney, elana, elayne, elaine, alaine, laine, alana
elaine => alun, alli, allyn, alona, lane, ally, lanny, alana, allie, alanna, alyn, alaina, lani, laney, laina, alaine, laine, elaina, elana, elayne
elana => elayne, laney, elaina, elaine, alaine, laine, alana
elary => ellory, ellery, elory, ellary, elery
elayne => alana, laine, alaine, elaine, elaina, laney, elana
elbert => alby, al, albert, adelbert, albrecht, albertus, alberto, bertel, berty, bertie, aubert, albie
elbridge => eldridge
elden => eldred, elder, alder
elder => elden, eldred, aldus, alder
eldred => elder, elden, alder
eldridge => elbridge
eleanor => eliana, nell, elinor, elinore, ellie, eleanore, eleanora, leonore, elie, elliana, leonora, ella
eleanora => eliana, elinor, elinore, ellie, eleanor, eleanore, nell, ella, leonore, elie, elliana, leonora
eleanore => eliana, nell, elinor, elinore, ellie, eleanor, eleanora, ella, leonore, elie, elliana, leonora
elen => elyn, elena, ellin, ellen, elin, ellyn
elena => elyn, ellin, ellen, elen, elin, ellyn, yelena, lena, ielena, jelena, laney
elery => elory, ellery, ellary, ellory, elary
elex => lex, lexus, elexus
elexus => lexus, lex, elex
elfred => alf, alfred, alfric, alfrid, alfie, freddie, fred, alfredo, allie
elgar => elger, alger
elger => alger, elgar
eli => eliott, elliot, eliot, ely, elliott, elijah, elia, ellsworth, eliha, eliakim, elias, ellys, ilya, ellison, ilja, elyas, ellis, elvyra, elvira, elvie, elvera, elva
elia => elijah, eliakim, elias, elyas, ellis, eli, ellsworth, eliha, ilja, ellison, ellys, ilya
eliakim => elijah, elia, ellsworth, eliha, elias, ellis, eli, ilja, ellison, ellys, elyas, ilya
eliana => nell, elinor, elinore, ellie, eleanor, eleanore, eleanora, ella, leonore, leonora, elie, elliana
elias => elijah, ilya, ellison, ilja, elyas, ellys, elia, ellsworth, eliha, eliakim, ellis, eli
elie => eliana, nell, elinor, leonore, elliana, leonora, ella, eleanora, eleanore, eleanor, ellie, elinore
eliha => elijah, eliakim, elias, ellis, eli, elia, ellsworth, elyas, ilja, ellison, ellys, ilya
elijah => ilya, ellison, ilja, elia, ellsworth, eliha, eliakim, elias, eli, ellis, ellys, elyas
elin => elena, elyn, ellin, ellen, elen, helaine, helene, helen, helena, ellyn
elinor => eliana, eleanor, eleanore, eleanora, leonore, leonora, ellie, nell, elinore, elie, elliana, ella
elinore => eliana, ellie, eleanor, eleanore, eleanora, leonore, leonora, elie, nell, elinor, elliana, ella
eliot => elliott, eliott, ely, elliot, eli
eliott => eli, ely, elliot, elliott, eliot
elisa => elyse, lisa, elysa, lyse, lisie, elise, lysa, lise
elisabeth => eliza, arlise, liz, ellie, bettie, elsa, elizabeth, arlisa, beth, betsy, isabella, elsie, betty, isabelle, lizzy, lisbeth, liza, isabel, bess, elise, libby, ellyzabeth, lizzie, bette, elysia, elpeth, ilse, elsbeth, elyse, aliza
elise => lisa, elysa, lyse, lisie, lise, elisa, lysa, eliza, liz, ellie, arlise, bettie, elsa, elizabeth, arlisa, beth, isabella, betsy, liza, isabel, elisabeth, elsbeth, aliza, ellyzabeth, libby, elsie, betty, isabelle, lizzy, bess, lisbeth, elpeth, lizzie, bette, elysia, ilse, elyse
elisha => elisheba
elisheba => elisha
eliza => elsbeth, elyse, aliza, ilse, beth, ellyzabeth, bess, elsie, elpeth, bette, elysia, isabella, betty, isabelle, lizzy, elise, lisbeth, liza, isabel, elisabeth, arlisa, arlise, betsy, ellie, liz, bettie, elizabeth, lizzie, elsa, libby
elizabeth => babette, betty, beth, liz, eliza, arlise, betsy, bette, elysia, isabella, arlisa, libby, elsa, lizzie, bettie, lizzy, elise, lisbeth, liza, isabel, elisabeth, elsbeth, elyse, aliza, ilse, ellyzabeth, bess, elsie, elpeth, ellie, isabelle
elke => ally, alejanda, lexy, aleksey, alexandra, zandra, lexie, alexa, sanie, aleka, axelia, alya, sandra, allesandra, alexandrina, alexis, alesandra, alexina, sandy, alessandra, aliki, alley, alexandria, alexine
ella => eliana, eleanore, eleanora, leonore, elie, elliana, leonora, eleanor, ellie, elinore, elinor, nell
ellary => elery, elory, ellery, ellory, elary
elle => eda, ady, addie, adalheld, ellie, adah, adalia, adelle, della, adalee, adelaide, adailia, adara, adele, adela, aline, adeline, etta
ellen => elyn, elena, ellin, elen, elin, ellyn
ellery => elery, elory, ellary, ellory, elary
elliana => eliana, ella, leonore, leonora, nell, elie, eleanora, eleanore, eleanor, ellie, elinore, elinor
ellie => eda, ady, addie, adalheld, adelaide, adara, adailia, elle, adele, adah, adalia, adelle, della, adalee, adela, aline, adeline, etta, ella, leonora, elliana, eliana, elinore, eleanor, eleanore, eleanora, leonore, nell, elinor, elie, betty, isabelle, eliza, arlise, lizzy, elise, lisbeth, liza, isabel, elisabeth, elsbeth, elyse, aliza, ilse, beth, ellyzabeth, bess, betsy, elsie, elpeth, bette, elysia, isabella, arlisa, libby, elsa, lizzie, elizabeth, bettie, liz
ellin => ellen, elen, elin, ellyn, elena, elyn
elliot => eli, eliott, elliott, eliot, ely
elliott => eliott, ely, elliot, eli, eliot
ellis => eli, elyas, ilja, ellison, ilya, elijah, ellys, elias, eliakim, eliha, ellsworth, elia
ellison => ilja, elyas, ellis, eli, ilya, elijah, ellys, elias, eliakim, eliha, ellsworth, elia
ellory => elary, ellery, elory, elery, ellary
ellsworth => elijah, eliha, eliakim, elias, ellis, eli, elia, elyas, ilja, ellison, ellys, ilya
ellyn => elyn, elena, ellin, ellen, elin, elen
ellys => ellis, eli, ilja, ellison, ilya, elias, eliakim, eliha, ellsworth, elia, elyas, elijah
ellyzabeth => arlise, eliza, isabella, ellie, bettie, beth, elizabeth, arlisa, betsy, elise, lizzie, betty, isabelle, lizzy, lisbeth, liza, isabel, elisabeth, elsbeth, elyse, aliza, bess, libby, elsa, bette, elysia, elsie, elpeth, ilse, liz
elman => elmar, elmer, elmore
elmar => elmer, elmore, elman
elmer => elmore, elman, elmar
elmore => elmer, elman, elmar
elo => el, eloise, elouise
eloisa => louise, lulu, luise, aloysia, luisa, loyce, louisa, louisiana, eloise, lulie, lisette, loise, ouise, luane, lu, luwana, lou, lois, ouisa, liusadh, luana
eloise => elo, el, louise, lulu, luise, aloysia, luisa, loyce, louisa, luana, lois, lisette, ouisa, loise, eloisa, ouise, lulie, louisiana, luane, lu, liusadh, luwana, lou, elouise
elory => ellery, ellary, ellory, elary, elery
elouise => eloise, elo, el
elpeth => arlise, eliza, elizabeth, bettie, beth, arlisa, betsy, isabella, ellie, lizzie, elsa, betty, isabelle, lizzy, elise, lisbeth, bette, elysia, liza, isabel, elisabeth, elsbeth, elyse, aliza, ellyzabeth, bess, elsie, libby, ilse, liz
elroy => elten, elton
elsa => arlise, elizabeth, bettie, betty, lizzy, elise, lisbeth, liza, isabel, elisabeth, betsy, ellie, lizzie, elsbeth, elyse, aliza, ilse, beth, ellyzabeth, bess, elsie, elpeth, bette, elysia, isabella, arlisa, libby, isabelle, eliza, liz
elsbeth => eliza, arlise, ellie, bettie, elizabeth, arlisa, beth, betsy, isabelle, lizzy, isabella, elsie, betty, elise, libby, ellyzabeth, elsa, lizzie, aliza, bette, elysia, elpeth, ilse, isabel, elisabeth, bess, elyse, lisbeth, liza, liz
elsie => arlise, eliza, bettie, beth, elizabeth, arlisa, betsy, isabella, lisbeth, liza, isabel, elisabeth, elsbeth, ellie, isabelle, lizzy, elise, lizzie, elsa, betty, libby, bette, elysia, aliza, ellyzabeth, bess, elpeth, ilse, elyse, liz
elte => elten
elten => elroy, elton, elte
elton => elroy, elten
elva => eli, elvina, elvira, elvera, elvyra, elvie
elvera => eli, elvyra, elvira, elvie, elva
elvie => eli, elvira, elvera, elvyra, elva
elvin => elwyn, elwin
elvina => elva
elvira => eli, elva, elvera, elvyra, elvie
elvyra => eli, elvera, elvie, elva, elvira
elwin => elwyn, elvin
elwyn => elwin, elvin
ely => elliot, eli, eliott, elliott, eliot
elyas => ellis, eli, elia, ilja, ellison, eliha, ellsworth, ellys, elias, eliakim, ilya, elijah
elyn => ellin, ellen, elen, elin, ellyn, elena
elysa => lisa, elise, elisa, lyse, lysa, lisie, lise, elyse
elyse => lisa, lise, lisie, liz, eliza, arlise, ellie, bettie, isabella, elizabeth, arlisa, beth, betsy, libby, ellyzabeth, elsa, lizzie, aliza, bette, elysia, elpeth, ilse, elsie, betty, isabelle, lizzy, lisbeth, liza, isabel, elisabeth, elsbeth, bess, lyse, elise, elisa, lysa, elysa
elysia => eliza, arlise, elizabeth, bettie, beth, isabella, arlisa, betsy, ellie, lizzie, elsa, betty, lizzy, elise, lisbeth, liza, isabel, elisabeth, elsbeth, elyse, aliza, ilse, ellyzabeth, bess, elsie, elpeth, bette, isabelle, libby, liz
luigi => lew, llewellyn, luthias, louis, chlodwig, lodovico, lou, lewes, ludwig, lewie, luis, lajos, clovis, lu, ludvig, louie, lewis
luis => luiz, luís, luthias, louis, chlodwig, lodovico, lou, lu, ludvig, lewes, ludwig, lewie, louie, lewis, lajos, clovis, luigi, lew, llewellyn
luisa => louise, luise, aloysia, loise, eloisa, ouise, lulie, louisiana, luane, eloise, loyce, louisa, liusadh, luana, luwana, lois, lisette, lou, ouisa, lu, lulu
luise => louise, ouise, aloysia, lulie, louisiana, luane, lu, eloise, loyce, liusadh, luana, luwana, lois, lisette, lou, ouisa, luisa, loise, eloisa, louisa, lulu
luitpold => leupold, leopold, leopoldo
